北京现在是几点	KNOWLEDGE_TIME	CITY:北京
伦敦当前是几点钟	KNOWLEDGE_TIME	CITY:伦敦
查一下多伦多是几点钟	KNOWLEDGE_TIME	CITY:多伦多
我想查下天津是几点	KNOWLEDGE_TIME	CITY:天津
查下上海是什么时间	KNOWLEDGE_TIME	CITY:上海
查下黑龙江是什么时间啊	KNOWLEDGE_TIME	PROVINCE:黑龙江
吉林现在是几点啊	KNOWLEDGE_TIME	PROVINCE:吉林
辽宁当前是几点钟啊	KNOWLEDGE_TIME	PROVINCE:辽宁
河北时间是	KNOWLEDGE_TIME	PROVINCE:河北
河南现在时间是	KNOWLEDGE_TIME	PROVINCE:河南
山西目前几点	KNOWLEDGE_TIME	PROVINCE:山西
鹤岗目前几点啊	KNOWLEDGE_TIME	CITY:鹤岗
看一下美国当前时间	KNOWLEDGE_TIME	STATE:美国
看一下巴黎现在时间吧	KNOWLEDGE_TIME	CITY:巴黎
搜一下安徽当前时间	KNOWLEDGE_TIME	PROVINCE:安徽
搜一下青海目前时间吧	KNOWLEDGE_TIME	PROVINCE:青海
帮我查下浙江现在时间	KNOWLEDGE_TIME	PROVINCE:浙江
帮我查下江西当前时间	KNOWLEDGE_TIME	PROVINCE:江西
帮我解答下湖北目前时间	KNOWLEDGE_TIME	PROVINCE:湖北
帮我解答下湖南目前时间啊	KNOWLEDGE_TIME	PROVINCE:湖南
帮我解答下福建现在时间	KNOWLEDGE_TIME	PROVINCE:福建
广东当前时间	KNOWLEDGE_TIME	PROVINCE:广东
广西现在时间是	KNOWLEDGE_TIME	PROVINCE:广西
四川目前时间为	KNOWLEDGE_TIME	PROVINCE:四川
云南此时此刻时间为	KNOWLEDGE_TIME	PROVINCE:云南
贵州此时此刻的时间是	KNOWLEDGE_TIME	PROVINCE:贵州
陕西此时此刻的时间为多少	KNOWLEDGE_TIME	PROVINCE:陕西
黑河此时此刻的时间是什么	KNOWLEDGE_TIME	CITY:黑河
甘肃当前时间为	KNOWLEDGE_TIME	PROVINCE:甘肃
青海现在时间为	KNOWLEDGE_TIME	PROVINCE:青海
海南目前时间是多少啊	KNOWLEDGE_TIME	PROVINCE:海南
台湾此时是几点啊	KNOWLEDGE_TIME	PROVINCE:台湾
香港此时是几点呐	KNOWLEDGE_TIME	CITY:香港
大庆此时是什么时间	KNOWLEDGE_TIME	CITY:大庆
卢森堡此时是什么时间啊	KNOWLEDGE_TIME	CITY:卢森堡
大连此时的时刻为多少	KNOWLEDGE_TIME	CITY:大连
葫芦岛现在的时刻为	KNOWLEDGE_TIME	CITY:葫芦岛
沈阳当前的时刻是多少	KNOWLEDGE_TIME	CITY:沈阳
鞍山目前的时刻为	KNOWLEDGE_TIME	CITY:鞍山
抚顺此刻的时间为	KNOWLEDGE_TIME	CITY:抚顺
本溪此刻的时间是	KNOWLEDGE_TIME	CITY:本溪
丹东此刻的时候	KNOWLEDGE_TIME	CITY:丹东
帮我查辽阳现在时间	KNOWLEDGE_TIME	CITY:辽阳
看一下铁岭现在时间	KNOWLEDGE_TIME	CITY:铁岭
帮我看一下朝阳现在时间	KNOWLEDGE_TIME	CITY:朝阳
帮我查盘锦现在时间吧	KNOWLEDGE_TIME	CITY:盘锦
看一下锦州现在时间吧	KNOWLEDGE_TIME	CITY:锦州
帮我看一下阜新现在时间呗	KNOWLEDGE_TIME	CITY:阜新
我要看长春现在时间	KNOWLEDGE_TIME	CITY:长春
看吉林四平时间	KNOWLEDGE_TIME	PROVINCE:吉林	CITY:四平
看下吉林通化时间吧	KNOWLEDGE_TIME	PROVINCE:吉林	CITY:通化
帮我查白山当前时间	KNOWLEDGE_TIME	CITY:白山
看一下辽源当前时间	KNOWLEDGE_TIME	CITY:辽源
帮我看一下白城当前时间	KNOWLEDGE_TIME	CITY:白城
帮我查松原当前时间吧	KNOWLEDGE_TIME	CITY:松原
看一下成都当前时间吧	KNOWLEDGE_TIME	CITY:成都
帮我看一下武汉当前时间呗	KNOWLEDGE_TIME	CITY:武汉
我要看襄阳当前时间	KNOWLEDGE_TIME	CITY:襄阳
看眉山当前时间	KNOWLEDGE_TIME	CITY:眉山
看下南充目前时间吧	KNOWLEDGE_TIME	CITY:南充
帮我查泸州目前时间	KNOWLEDGE_TIME	CITY:泸州
看一下德阳目前时间	KNOWLEDGE_TIME	CITY:德阳
帮我看一下广元目前时间	KNOWLEDGE_TIME	CITY:广元
帮我查乐山目前时间吧	KNOWLEDGE_TIME	CITY:乐山
看一下郑州目前时间吧	KNOWLEDGE_TIME	CITY:郑州
帮我看一下安阳目前时间呗	KNOWLEDGE_TIME	CITY:安阳
我要看嘉兴目前时间	KNOWLEDGE_TIME	CITY:嘉兴
看苏州目前时间	KNOWLEDGE_TIME	CITY:苏州
看下杭州此时时间吧	KNOWLEDGE_TIME	CITY:杭州
帮我查雅安此时的时间	KNOWLEDGE_TIME	CITY:雅安
看一下石家庄此时时间	KNOWLEDGE_TIME	CITY:石家庄
帮我看一下唐山此时时间	KNOWLEDGE_TIME	CITY:唐山
帮我查邯郸此时时间吧	KNOWLEDGE_TIME	CITY:邯郸
看一下秦皇岛此时时间吧	KNOWLEDGE_TIME	CITY:秦皇岛
帮我看一下陵水此时时间呗	KNOWLEDGE_TIME	CITY:陵水
我要看昌江此时时间	KNOWLEDGE_TIME	CITY:昌江
看东方此时时间	KNOWLEDGE_TIME	CITY:东方
看下白沙此时时间吧	KNOWLEDGE_TIME	CITY:白沙
帮我查澳大利亚此刻时间	KNOWLEDGE_TIME	STATE:澳大利亚
看一下东京此刻时间	KNOWLEDGE_TIME	CITY:东京
帮我看一下葡萄牙此刻时间	KNOWLEDGE_TIME	STATE:葡萄牙
帮我查缅甸此刻时间吧	KNOWLEDGE_TIME	STATE:缅甸
看一下老挝此刻时间吧	KNOWLEDGE_TIME	STATE:老挝
帮我看一下越南此刻时间呗	KNOWLEDGE_TIME	STATE:越南
我要看西班牙此刻时间	KNOWLEDGE_TIME	STATE:西班牙
看新疆此刻时间	KNOWLEDGE_TIME	PROVINCE:新疆
看下内蒙古此刻时间吧	KNOWLEDGE_TIME	PROVINCE:内蒙古
显示俄罗斯当前时间	KNOWLEDGE_TIME	STATE:俄罗斯
查下桂林的时间	KNOWLEDGE_TIME	CITY:桂林
给我看下大同时间	KNOWLEDGE_TIME	CITY:大同
给我看下太谷目前时间	KNOWLEDGE_TIME	CITY:太谷
我要知道曼谷现在的时间	KNOWLEDGE_TIME	CITY:曼谷
显示悉尼当前时刻是多少	KNOWLEDGE_TIME	CITY:悉尼
查下阳泉的时刻是多少	KNOWLEDGE_TIME	CITY:阳泉
给我看下淄博的当前时刻	KNOWLEDGE_TIME	CITY:淄博
给我看下威海目前时刻为多少	KNOWLEDGE_TIME	CITY:威海
我要知道渤海现在的时刻是多少	KNOWLEDGE_TIME	CITY:渤海
显示菏泽当前时间点	KNOWLEDGE_TIME	CITY:菏泽
查下加拿大的时间点	KNOWLEDGE_TIME	STATE:加拿大
给我看下随州时间点	KNOWLEDGE_TIME	CITY:随州
给我看下希腊目前时间点	KNOWLEDGE_TIME	STATE:希腊
我要知道三亚现在的时间点	KNOWLEDGE_TIME	CITY:三亚
我想知道罗马现在几点	KNOWLEDGE_TIME	CITY:罗马
告诉我巴黎现在几点	KNOWLEDGE_TIME	CITY:巴黎
能告诉我黄石现在几点吗	KNOWLEDGE_TIME	CITY:黄石
请告诉我现在衡水几点	KNOWLEDGE_TIME	CITY:衡水
告诉我沧州时间	KNOWLEDGE_TIME	CITY:沧州
说一下廊坊现在的时间吧	KNOWLEDGE_TIME	CITY:廊坊
给我说下现在邢台的时间	KNOWLEDGE_TIME	CITY:邢台
我要知道保定此刻的时间点	KNOWLEDGE_TIME	CITY:保定
我想知道张家口此刻几点	KNOWLEDGE_TIME	CITY:张家口
告诉我承德此刻几点	KNOWLEDGE_TIME	CITY:承德
能告诉我洛阳此刻几点吗	KNOWLEDGE_TIME	CITY:洛阳
请告诉我此刻许昌几点	KNOWLEDGE_TIME	CITY:许昌
说一下新疆目前的时间吧	KNOWLEDGE_TIME	PROVINCE:新疆
给我说下目前宜昌的时间	KNOWLEDGE_TIME	CITY:宜昌
我要知道宜宾目前的时间点	KNOWLEDGE_TIME	CITY:宜宾
我想知道周口目前几点	KNOWLEDGE_TIME	CITY:周口
告诉我驻马店目前几点	KNOWLEDGE_TIME	CITY:驻马店
能告诉我新乡目前几点吗	KNOWLEDGE_TIME	CITY:新乡
请告诉我目前商丘几点	KNOWLEDGE_TIME	CITY:商丘
说一下荆门当前的时间吧	KNOWLEDGE_TIME	CITY:荆门
给我说下当前漯河的时间	KNOWLEDGE_TIME	CITY:漯河
我要知道同心当前的时间点	KNOWLEDGE_TIME	CITY:同心
我想知道中卫当前几点	KNOWLEDGE_TIME	CITY:中卫
告诉我日本当前几点	KNOWLEDGE_TIME	STATE:日本
能告诉我聊城当前几点吗	KNOWLEDGE_TIME	CITY:聊城
请告诉我当前济南几点	KNOWLEDGE_TIME	CITY:济南
说一下新加坡当前的时间吧	KNOWLEDGE_TIME	STATE:新加坡
给我说下当前濮阳的时间	KNOWLEDGE_TIME	CITY:濮阳
非洲现在几点钟	KNOWLEDGE_TIME	STATE:非洲
菲律宾当地时间是几点	KNOWLEDGE_TIME	STATE:菲律宾
弗罗里达现在是什么时间	KNOWLEDGE_TIME	PROVINCE:弗罗里达
加州现在几点钟	KNOWLEDGE_TIME	CITY:加州
张三，现在几点了	KNOWLEDGE_TIME
小笨笨现在什么时间	KNOWLEDGE_TIME
小迪现在几点钟了	KNOWLEDGE_TIME
泰迪现在几点了	KNOWLEDGE_TIME
叶博现在几点了	KNOWLEDGE_TIME
