菊花台是谁的歌	MUIC_FIND_ARTIST	TITLE:菊花台
歌曲晴天是谁的歌	MUIC_FIND_ARTIST	TITLE:晴天
歌曲告白气球是谁的	MUIC_FIND_ARTIST	TITLE:告白气球
歌双截棍是谁的歌	MUIC_FIND_ARTIST	TITLE:双截棍
千里之外是谁唱的	MUIC_FIND_ARTIST	TITLE:千里之外
歌曲算什么男人是谁唱的	MUIC_FIND_ARTIST	TITLE:算什么男人
给我一首歌的时间是谁唱的歌啊	MUIC_FIND_ARTIST	TITLE:给我一首歌的时间
烟花易冷是谁唱的歌	MUIC_FIND_ARTIST	TITLE:烟花易冷
发如雪谁唱的歌	MUIC_FIND_ARTIST	TITLE:发如雪
朋友的酒谁唱的	MUIC_FIND_ARTIST	TITLE:朋友的酒
牛仔很忙是哪个歌手的	MUIC_FIND_ARTIST	TITLE:牛仔很忙
漂洋过海来看你是哪个唱的	MUIC_FIND_ARTIST	TITLE:漂洋过海来看你
查下蒲公英的约定是哪个歌手的	MUIC_FIND_ARTIST	TITLE:蒲公英的约定
查一下听妈妈的话是哪个歌手的	MUIC_FIND_ARTIST	TITLE:听妈妈的话
以父之名是哪位歌手的	MUIC_FIND_ARTIST	TITLE:以父之名
找下爱的供养是哪位歌手的	MUIC_FIND_ARTIST	TITLE:爱的供养
找一下生来彷徨是哪位歌手的	MUIC_FIND_ARTIST	TITLE:生来彷徨
说一下存在是谁唱的	MUIC_FIND_ARTIST	TITLE:存在
说下海阔天空是谁唱的	MUIC_FIND_ARTIST	TITLE:海阔天空
离歌是哪位唱的	MUIC_FIND_ARTIST	TITLE:离歌
最炫名族风是哪位歌手唱的	MUIC_FIND_ARTIST	TITLE:最炫名族风
查一下遇见是谁唱的	MUIC_FIND_ARTIST	TITLE:遇见
查下一笑而过是谁唱的	MUIC_FIND_ARTIST	TITLE:一笑而过
查一下征服谁唱的	MUIC_FIND_ARTIST	TITLE:征服
查一下第一夫人谁唱的啊	MUIC_FIND_ARTIST	TITLE:第一夫人
找下夜空中最亮的星是谁唱的	MUIC_FIND_ARTIST	TITLE:空中最亮的星
找一下我们都一样是谁唱的	MUIC_FIND_ARTIST	TITLE:我们都一样
给我说下时光小偷是谁唱的啊	MUIC_FIND_ARTIST	TITLE:时光小偷
搜一下似火年华谁唱的	MUIC_FIND_ARTIST	TITLE:似火年华
搜下愚人的国度谁唱的吧	MUIC_FIND_ARTIST	TITLE:愚人的国度
给我搜下和你一样谁唱的啊	MUIC_FIND_ARTIST	TITLE:和你一样
给我搜一下怒放的生命谁唱的啊	MUIC_FIND_ARTIST	TITLE:怒放的生命
哪个唱的像梦一样自由	MUIC_FIND_ARTIST	TITLE:像梦一样自由
谁唱的飞得更高	MUIC_FIND_ARTIST	TITLE:飞得更高
谁唱的一起摇摆啊	MUIC_FIND_ARTIST	TITLE:一起摇摆
谁的歌是再见青春	MUIC_FIND_ARTIST	TITLE:再见青春
谁的歌曲是白天不懂夜的黑	MUIC_FIND_ARTIST	TITLE:白天不懂夜的黑
谁的歌曲是醉赤壁啊	MUIC_FIND_ARTIST	TITLE:醉赤壁
哪个唱的小酒窝	MUIC_FIND_ARTIST	TITLE:小酒窝
哪个的歌是一千年以后	MUIC_FIND_ARTIST	TITLE:一千年以后
哪个唱的像风一样自由啊	MUIC_FIND_ARTIST	TITLE:像风一样自由
哪个歌手唱的曾经的你	MUIC_FIND_ARTIST	TITLE:曾经的你
哪个歌手的歌是此时此刻	MUIC_FIND_ARTIST	TITLE:此时此刻
哪个歌手的歌曲是一路逆风	MUIC_FIND_ARTIST	TITLE:一路逆风
哪位唱的你把我灌醉	MUIC_FIND_ARTIST	TITLE:你把我灌醉
哪位的歌是单行的轨道	MUIC_FIND_ARTIST	TITLE:单行的轨道
哪位歌手唱的错过的花季	MUIC_FIND_ARTIST	TITLE:错过的花季
哪位歌手唱的一万个舍不得啊	MUIC_FIND_ARTIST	TITLE:一万个舍不得
哪位歌手的歌是为情所伤啊	MUIC_FIND_ARTIST	TITLE:为情所伤
哪位歌手的歌曲是爱情转移	MUIC_FIND_ARTIST	TITLE:爱情转移
在这个世界相遇是谁的专辑啊	MUIC_FIND_ARTIST	ALBUM_NAME:在这个世界相遇
我很忙的专辑是谁的	MUIC_FIND_ARTIST	ALBUM_NAME:我很忙
十二星座的专辑是谁的啊	MUIC_FIND_ARTIST	ALBUM_NAME:十二星座
查一下魔杰座的专辑是谁的	MUIC_FIND_ARTIST	ALBUM_NAME:魔杰座
查下jay的专辑是谁的	MUIC_FIND_ARTIST	ALBUM_NAME:jay
给我查下十一月的萧邦的专辑是谁的	MUIC_FIND_ARTIST	ALBUM_NAME:十一月的萧邦
给我查下范特西专辑是谁的啊	MUIC_FIND_ARTIST	ALBUM_NAME:范特西
专辑七里香是谁的啊	MUIC_FIND_ARTIST	ALBUM_NAME:七里香
专辑名惊叹号是谁的	MUIC_FIND_ARTIST	ALBUM_NAME:惊叹号
专辑名字依然范特西是谁的	MUIC_FIND_ARTIST	ALBUM_NAME:依然范特西
专辑名称叶惠美是谁的啊	MUIC_FIND_ARTIST	ALBUM_NAME:叶惠美
查一下专辑霍元甲是谁的	MUIC_FIND_ARTIST	ALBUM_NAME:霍元甲
说下专辑看我七十二变是谁的	MUIC_FIND_ARTIST	ALBUM_NAME:看我七十二变
说下专辑八度空间是哪个的	MUIC_FIND_ARTIST	ALBUM_NAME:八度空间
说下专辑一个人的是哪个歌手的	MUIC_FIND_ARTIST	ALBUM_NAME:一个人的
专辑情花是哪个歌手的	MUIC_FIND_ARTIST	ALBUM_NAME:情花
专辑名情歌悠扬是哪个歌手的	MUIC_FIND_ARTIST	ALBUM_NAME:情歌悠扬
专辑名字天涯码头是哪个歌手的	MUIC_FIND_ARTIST	ALBUM_NAME:天涯码头
专辑吼是哪位歌手的	MUIC_FIND_ARTIST	ALBUM_NAME:吼
专辑名我真的一点都不孤单是哪位歌手的	MUIC_FIND_ARTIST	ALBUM_NAME:我真的一点都不孤单
专辑名字陪我去流浪是哪位歌手的	MUIC_FIND_ARTIST	ALBUM_NAME:陪我去流浪
找下专辑名字梦缠绵是哪位歌手的	MUIC_FIND_ARTIST	ALBUM_NAME:梦缠绵
问下专辑名字无限速是哪位歌手的	MUIC_FIND_ARTIST	ALBUM_NAME:无限速
问一下专辑名字哭笑不得是哪位歌手的	MUIC_FIND_ARTIST	ALBUM_NAME:哭笑不得
说下专辑名字默是哪位歌手的	MUIC_FIND_ARTIST	ALBUM_NAME:默
说下专辑白天不懂夜的黑是哪个歌手的作品	MUIC_FIND_ARTIST	ALBUM_NAME:白天不懂夜的黑
谁的专辑是有个爱你的人不容易	MUIC_FIND_ARTIST	ALBUM_NAME:有个爱你的人不容易
谁的专辑名是真的很在乎	MUIC_FIND_ARTIST	ALBUM_NAME:真的很在乎
哪个的专辑是不息之河	MUIC_FIND_ARTIST	ALBUM_NAME:不息之河
哪个歌手的专辑是今晚二十岁	MUIC_FIND_ARTIST	ALBUM_NAME:今晚二十岁
找下哪个歌手的专辑是无所谓	MUIC_FIND_ARTIST	ALBUM_NAME:无所谓
查一下哪个歌手的专辑是牧马人	MUIC_FIND_ARTIST	ALBUM_NAME:牧马人
查下哪个歌手的专辑是黑白灰	MUIC_FIND_ARTIST	ALBUM_NAME:黑白灰
找一下哪个歌手的专辑是认了吧	MUIC_FIND_ARTIST	ALBUM_NAME:认了吧
哪个的专辑名是不想放手	MUIC_FIND_ARTIST	ALBUM_NAME:不想放手
哪个的专辑名字是浮夸	MUIC_FIND_ARTIST	ALBUM_NAME:浮夸
哪位的专辑名是好久不见	MUIC_FIND_ARTIST	ALBUM_NAME:好久不见
哪位歌手的专辑是抽离回忆	MUIC_FIND_ARTIST	ALBUM_NAME:抽离回忆
查一下哪位歌手的专辑是一万个舍不得	MUIC_FIND_ARTIST	ALBUM_NAME:一万个舍不得
查下哪位歌手的专辑是真的不容易	MUIC_FIND_ARTIST	ALBUM_NAME:真的不容易
哪位歌手的专辑名是好可惜	MUIC_FIND_ARTIST	ALBUM_NAME:好可惜
查一下哪位歌手的专辑名是我知道	MUIC_FIND_ARTIST	ALBUM_NAME:我知道
查下哪位歌手的专辑名是我选择原谅	MUIC_FIND_ARTIST	ALBUM_NAME:我选择原谅
哪位歌手的专辑名字是分分合合	MUIC_FIND_ARTIST	ALBUM_NAME:分分合合
找下哪位歌手的专辑名字是与我无关	MUIC_FIND_ARTIST	ALBUM_NAME:与我无关
找一下哪位歌手的专辑名字是放过自己	MUIC_FIND_ARTIST	ALBUM_NAME:放过自己
哪个乐队演奏的这个歌曲	MUIC_FIND_ARTIST	ANAPHOR:这个歌曲
这个歌曲的演唱者是谁	MUIC_FIND_ARTIST	ANAPHOR:这个歌曲
哪位艺术家演唱的这首歌	MUIC_FIND_ARTIST	ANAPHOR:这首歌
哪位艺术家演奏的这个曲子	MUIC_FIND_ARTIST	ANAPHOR:这个曲子
演奏这个歌曲的艺术家叫什么	MUIC_FIND_ARTIST	ANAPHOR:这个歌曲
这个歌曲是周杰伦唱的么	MUIC_FIND_ARTIST	ANAPHOR:这个歌曲	ARTIST:周杰伦
这个歌手是谁啊	MUIC_FIND_ARTIST
这个歌词是谁写的	MUIC_FIND_ARTIST
能不能告诉我这个歌曲的作曲家是谁	MUIC_FIND_ARTIST:这个歌曲
哪位作曲家写的这个歌曲的五线谱	MUIC_FIND_ARTIST:这个歌曲
谁给这首歌写的歌词	MUIC_FIND_ARTIST:这首歌
我想知道谁唱的这个歌曲	MUIC_FIND_ARTIST:这个歌曲
谁写的这首歌的歌词啊	MUIC_FIND_ARTIST	ANAPHOR:这首歌
这首歌的作词家和作曲家分别是谁	MUIC_FIND_ARTIST	ANAPHOR:这首歌
这首曲子是由哪个歌手演唱的	MUIC_FIND_ARTIST	ANAPHOR:这首曲子
这首曲子是谁做的词	MUIC_FIND_ARTIST	ANAPHOR:这首曲子
告诉我这首歌的作曲叫什么	MUIC_FIND_ARTIST	ANAPHOR:这首歌
这个歌曲出自哪个乐队	MUIC_FIND_ARTIST	ANAPHOR:这个歌曲
谁唱的这首歌	MUIC_FIND_ARTIST	ANAPHOR:这首歌
告诉我谁唱过这首歌	MUIC_FIND_ARTIST	ANAPHOR:这首歌
这首歌是谁演唱的	MUIC_FIND_ARTIST	ANAPHOR:这首歌
这首歌的作家是谁	MUIC_FIND_ARTIST	ANAPHOR:这首歌
这首歌是谁唱的	MUIC_FIND_ARTIST	ANAPHOR:这首歌
谁演奏的这个歌曲	MUIC_FIND_ARTIST	ANAPHOR:这个歌曲
谁的歌是勇敢一点	MUIC_FIND_ARTIST	TITLE:勇敢一点
谁唱的真心英雄	MUIC_FIND_ARTIST	TITLE:真心英雄
谁唱的是爱我中华	MUIC_FIND_ARTIST	TITLE:爱我中华
谁唱的是冬天快乐啊	MUIC_FIND_ARTIST	TITLE:冬天快乐
谁唱的歌是蓝莲花啊	MUIC_FIND_ARTIST	TITLE:蓝莲花
我想知道谁唱的是遇见	MUIC_FIND_ARTIST	TITLE:遇见
谁唱的歌是青藏高原	MUIC_FIND_ARTIST	TITLE:青藏高原
找一下谁唱的歌是第一夫人	MUIC_FIND_ARTIST	TITLE:第一夫人
给我找一下谁唱的歌是夜空中最亮的星	MUIC_FIND_ARTIST	TITLE:夜空中最亮的星
给我找一下谁的歌是喜欢你	MUIC_FIND_ARTIST	TITLE:喜欢你
找下谁唱的歌是青藏高原	MUIC_FIND_ARTIST	TITLE:青藏高原
找下谁唱的歌曲是好运来	MUIC_FIND_ARTIST	TITLE:好运来
我想知道谁唱的歌是天路	MUIC_FIND_ARTIST	TITLE:天路
谁的专辑是十月的肖邦	MUIC_FIND_ARTIST	ALBUM_NAME:十月的肖邦
哪个唱的黑色幽默	MUIC_FIND_ARTIST	TITLE:黑色幽默
哪个歌手唱的以父之名	MUIC_FIND_ARTIST	TITLE:以父之名
哪个歌手唱的是春天里	MUIC_FIND_ARTIST	TITLE:春天里
哪位歌手唱的私奔	MUIC_FIND_ARTIST	TITLE:私奔
哪位歌手唱的是单行的轨道	MUIC_FIND_ARTIST	TITLE:单行的轨道
哪个艺术家唱的蒲公英的约定	MUIC_FIND_ARTIST	TITLE:蒲公英的约定
说一下来日方长是谁唱的	MUIC_FIND_ARTIST	TITLE:来日方长
说一下黄色枫叶是谁唱的	MUIC_FIND_ARTIST	TITLE:黄色枫叶
说下丑八怪是谁唱的	MUIC_FIND_ARTIST	TITLE:丑八怪
说下方圆几里是谁唱的歌	MUIC_FIND_ARTIST	TITLE:方圆几里
给我说下演员是谁唱的	MUIC_FIND_ARTIST	TITLE:演员
给我说下模特是谁唱的歌	MUIC_FIND_ARTIST	TITLE:模特
