播放朴有天作词的歌	MUSIC_PLAY	LYRICIST:朴有天
播放张国荣写的音乐	MUSIC_PLAY	LYRICIST:张国荣
播放邓丽君作词的歌	MUSIC_PLAY	LYRICIST:邓丽君
播放下周杰伦作词的音乐	MUSIC_PLAY	LYRICIST:周杰伦
来首七堇年写的歌	MUSIC_PLAY	LYRICIST:七堇年
来首朴树作词的歌	MUSIC_PLAY	LYRICIST:朴树
来个周杰伦作词的音乐	MUSIC_PLAY	LYRICIST:周杰伦
来个林夕作词的歌	MUSIC_PLAY	LYRICIST:林夕
我要听黄沾作词的音乐	MUSIC_PLAY	LYRICIST:黄沾
我要听吴青峰写的歌曲	MUSIC_PLAY	LYRICIST:吴青峰
我要听崔健作词的歌	MUSIC_PLAY	LYRICIST:崔健
我想听林夕作词的音乐	MUSIC_PLAY	LYRICIST:林夕
放一首光良写的歌曲	MUSIC_PLAY	LYRICIST:光良
放一首王菲作词的歌	MUSIC_PLAY	LYRICIST:王菲
放一首蔡依林写的格	MUSIC_PLAY	LYRICIST:蔡依林
放一下林俊杰作词的歌曲	MUSIC_PLAY	LYRICIST:林俊杰
放一下张韶涵写的音乐	MUSIC_PLAY	LYRICIST:张韶涵
放一下张含韵作词的歌	MUSIC_PLAY	LYRICIST:张含韵
放个柯肇雷作词的歌曲	MUSIC_PLAY	LYRICIST:柯肇雷
放个罗大佑写的歌	MUSIC_PLAY	LYRICIST:罗大佑
放个韩红写的音乐	MUSIC_PLAY	LYRICIST:韩红
想听方文山作词的歌	MUSIC_PLAY	LYRICIST:方文山
听一下姚谦作词的歌	MUSIC_PLAY	LYRICIST:姚谦
来曲黄沾写的歌	MUSIC_PLAY	LYRICIST:黄沾
来首冼星海作曲的歌	MUSIC_PLAY	COMPOSER:冼星海
来首陈一发作曲的音乐	MUSIC_PLAY	COMPOSER:陈一发
放下谢春花作曲的歌	MUSIC_PLAY	COMPOSER:谢春花
放下陈奕迅谱曲的歌	MUSIC_PLAY	COMPOSER:陈奕迅
播下薛之谦作曲的音乐	MUSIC_PLAY	COMPOSER:薛之谦
播下李宗盛作曲的歌	MUSIC_PLAY	COMPOSER:李宗盛
我要听赵雷作曲的歌	MUSIC_PLAY	COMPOSER:赵雷
我要听陈粒谱曲的歌	MUSIC_PLAY	COMPOSER:陈粒
有没有孙燕姿作曲的歌	MUSIC_PLAY	COMPOSER:孙燕姿
有没有吴青峰作曲的歌	MUSIC_PLAY	COMPOSER:吴青峰
放首王力宏谱曲的歌	MUSIC_PLAY	COMPOSER:王力宏
想听宋冬野作曲的音乐	MUSIC_PLAY	COMPOSER:宋冬野
放一曲阿信作曲的音乐	MUSIC_PLAY	COMPOSER:阿信
张信哲作曲的歌都给我放一下	MUSIC_PLAY	COMPOSER:张信哲
陈绮贞作曲的歌都给我播一下	MUSIC_PLAY	COMPOSER:陈绮贞
播放李克勤作曲方文山写的歌曲	MUSIC_PLAY	LYRICIST:方文山	COMPOSER:李克勤
放下容祖儿作曲陈小春作词的歌曲	MUSIC_PLAY	LYRICIST:陈小春	COMPOSER:容祖儿
放一首梁静茹演唱张惠妹作曲的歌曲	MUSIC_PLAY	COMPOSER:张惠妹	ARTIST:梁静茹
来首刘德华唱张宇作曲的歌曲	MUSIC_PLAY	COMPOSER:张宇	ARTIST:刘德华
播放银临唱的不才写的歌曲	MUSIC_PLAY	LYRICIST:不才	ARTIST:银临
来首古巨基唱的谢安其作词的歌	MUSIC_PLAY	LYRICIST:谢安其	ARTIST:古巨基
刘德华和梅艳芳合唱的歌	MUSIC_PLAY	ARTIST:刘德华	ARTIST:梅艳芳
来首金志文和汤晓菲合唱的歌	MUSIC_PLAY	ARTIST:金志文	ARTIST:汤晓菲
放下林俊杰和蔡卓妍合唱的歌	MUSIC_PLAY	ARTIST:林俊杰	ARTIST:蔡卓妍
听一下张信哲和徐佳莹合唱的歌	MUSIC_PLAY	ARTIST:张信哲	ARTIST:徐佳莹
想听王菲唱的李宗盛作词的歌	MUSIC_PLAY	LYRICIST:李宗盛	ARTIST:王菲
