刘德华的本名是什么	KNOWLEDGE_FOR_WIKIPEDIA_PEOPLE	SUBJECT_NAME:刘德华	ATTRIBUTE:本名
刘德华的故乡在哪里	KNOWLEDGE_FOR_WIKIPEDIA_PEOPLE	SUBJECT_NAME:刘德华	ATTRIBUTE:故乡
刘德华的生日是哪一天	KNOWLEDGE_FOR_WIKIPEDIA_PEOPLE	SUBJECT_NAME:刘德华	ATTRIBUTE:生日
刘德华来自什么地方	KNOWLEDGE_FOR_WIKIPEDIA_PEOPLE	SUBJECT_NAME:刘德华	ATTRIBUTE:来自什么地方
刘德华是哪国人	KNOWLEDGE_FOR_WIKIPEDIA_PEOPLE	SUBJECT_NAME:刘德华	ATTRIBUTE:哪国人
刘德华是哪年出生的	KNOWLEDGE_FOR_WIKIPEDIA_PEOPLE	SUBJECT_NAME:刘德华	ATTRIBUTE:出生
刘德华是男的还是女的	KNOWLEDGE_FOR_WIKIPEDIA_PEOPLE	SUBJECT_NAME:刘德华	ATTRIBUTE:男的还是女的
刘德华是什么国家的人	KNOWLEDGE_FOR_WIKIPEDIA_PEOPLE	SUBJECT_NAME:刘德华	ATTRIBUTE:国家
刘德华是什么星座的	KNOWLEDGE_FOR_WIKIPEDIA_PEOPLE	SUBJECT_NAME:刘德华	ATTRIBUTE:星座
爱因斯坦是哪国人	KNOWLEDGE_FOR_WIKIPEDIA_PEOPLE	SUBJECT_NAME:爱因斯坦	ATTRIBUTE:哪国人
爱因斯坦是哪一年出生的	KNOWLEDGE_FOR_WIKIPEDIA_PEOPLE	SUBJECT_NAME:爱因斯坦	ATTRIBUTE:出生
安妮斯顿多大了	KNOWLEDGE_FOR_WIKIPEDIA_PEOPLE	SUBJECT_NAME:安妮斯顿	ATTRIBUTE:多大
奥巴马出生在什么地方	KNOWLEDGE_FOR_WIKIPEDIA_PEOPLE	SUBJECT_NAME:奥巴马	ATTRIBUTE:出生
奥巴马的生日在哪一天	KNOWLEDGE_FOR_WIKIPEDIA_PEOPLE	SUBJECT_NAME:奥巴马	ATTRIBUTE:生日
奥巴马多大了	KNOWLEDGE_FOR_WIKIPEDIA_PEOPLE	SUBJECT_NAME:奥巴马	ATTRIBUTE:多大
奥巴马多大岁数了	KNOWLEDGE_FOR_WIKIPEDIA_PEOPLE	SUBJECT_NAME:奥巴马	ATTRIBUTE:岁数
奥巴马多少岁	KNOWLEDGE_FOR_WIKIPEDIA_PEOPLE	SUBJECT_NAME:奥巴马	ATTRIBUTE:多少岁
奥巴马多少岁了	KNOWLEDGE_FOR_WIKIPEDIA_PEOPLE	SUBJECT_NAME:奥巴马	ATTRIBUTE:多少岁
奥巴马今年多大	KNOWLEDGE_FOR_WIKIPEDIA_PEOPLE	SUBJECT_NAME:奥巴马	YEAR_RANGE:今年	ATTRIBUTE:多大
奥巴马今年多大了	KNOWLEDGE_FOR_WIKIPEDIA_PEOPLE	SUBJECT_NAME:奥巴马	YEAR_RANGE:今年	ATTRIBUTE:多大
奥巴马什么时候出生的	KNOWLEDGE_FOR_WIKIPEDIA_PEOPLE	SUBJECT_NAME:奥巴马	ATTRIBUTE:出生
奥巴马总统多大了？	KNOWLEDGE_FOR_WIKIPEDIA_PEOPLE	SUBJECT_NAME:奥巴马	DESCRIPTION:总统	ATTRIBUTE:多大
奥巴马总统多大年纪了	KNOWLEDGE_FOR_WIKIPEDIA_PEOPLE	SUBJECT_NAME:奥巴马	DESCRIPTION:总统	ATTRIBUTE:年纪
比尔盖茨多大了	KNOWLEDGE_FOR_WIKIPEDIA_PEOPLE	SUBJECT_NAME:比尔盖茨	ATTRIBUTE:多大
比尔克林顿多大了	KNOWLEDGE_FOR_WIKIPEDIA_PEOPLE	SUBJECT_NAME:比尔克林顿	ATTRIBUTE:多大
碧昂丝什么时候有她的宝宝	KNOWLEDGE_FOR_WIKIPEDIA_PEOPLE	SUBJECT_NAME:碧昂丝	ATTRIBUTE:宝宝
碧昂斯的身高是多少	KNOWLEDGE_FOR_WIKIPEDIA_PEOPLE	SUBJECT_NAME:碧昂斯	ATTRIBUTE:身高
碧昂斯的生日是几月份	KNOWLEDGE_FOR_WIKIPEDIA_PEOPLE	SUBJECT_NAME:碧昂斯	ATTRIBUTE:生日
碧昂斯多少岁了	KNOWLEDGE_FOR_WIKIPEDIA_PEOPLE	SUBJECT_NAME:碧昂斯	ATTRIBUTE:多少岁
碧昂斯哪一年出道	KNOWLEDGE_FOR_WIKIPEDIA_PEOPLE	SUBJECT_NAME:碧昂斯	ATTRIBUTE:出道
碧昂斯有多高	KNOWLEDGE_FOR_WIKIPEDIA_PEOPLE	SUBJECT_NAME:碧昂斯	ATTRIBUTE:多高
碧昂斯有多老	KNOWLEDGE_FOR_WIKIPEDIA_PEOPLE	SUBJECT_NAME:碧昂斯	ATTRIBUTE:多老
冰心出生在哪一年	KNOWLEDGE_FOR_WIKIPEDIA_PEOPLE	SUBJECT_NAME:冰心	ATTRIBUTE:出生
冰心的原名是什么	KNOWLEDGE_FOR_WIKIPEDIA_PEOPLE	SUBJECT_NAME:冰心	ATTRIBUTE:原名
冰心是哪里人	KNOWLEDGE_FOR_WIKIPEDIA_PEOPLE	SUBJECT_NAME:冰心	ATTRIBUTE:哪里人
冰心有哪些主要作品	KNOWLEDGE_FOR_WIKIPEDIA_PEOPLE	SUBJECT_NAME:冰心	ATTRIBUTE:主要作品
布兰妮多大了	KNOWLEDGE_FOR_WIKIPEDIA_PEOPLE	SUBJECT_NAME:布兰妮	ATTRIBUTE:多大
布兰妮斯皮尔斯结婚	KNOWLEDGE_FOR_WIKIPEDIA_PEOPLE	SUBJECT_NAME:布兰妮斯皮尔斯	ATTRIBUTE:结婚
布鲁斯威利斯出生在哪一年	KNOWLEDGE_FOR_WIKIPEDIA_PEOPLE	SUBJECT_NAME:布鲁斯威利斯	ATTRIBUTE:出生
布鲁斯威利斯的年龄是多少	KNOWLEDGE_FOR_WIKIPEDIA_PEOPLE	SUBJECT_NAME:布鲁斯威利斯	ATTRIBUTE:年龄
布鲁斯威利斯有多大了	KNOWLEDGE_FOR_WIKIPEDIA_PEOPLE	SUBJECT_NAME:布鲁斯威利斯	ATTRIBUTE:多大
陈冠希多大了	KNOWLEDGE_FOR_WIKIPEDIA_PEOPLE	SUBJECT_NAME:陈冠希	ATTRIBUTE:多大
陈冠希多少岁了	KNOWLEDGE_FOR_WIKIPEDIA_PEOPLE	SUBJECT_NAME:陈冠希	ATTRIBUTE:多少岁
陈奕迅多大年纪了	KNOWLEDGE_FOR_WIKIPEDIA_PEOPLE	SUBJECT_NAME:陈奕迅	ATTRIBUTE:年纪
成龙的家乡是哪里	KNOWLEDGE_FOR_WIKIPEDIA_PEOPLE	SUBJECT_NAME:成龙	ATTRIBUTE:家乡
成龙今年多少岁	KNOWLEDGE_FOR_WIKIPEDIA_PEOPLE	SUBJECT_NAME:成龙	YEAR_RANGE:今年	ATTRIBUTE:多少岁
韩庚的家乡在哪里	KNOWLEDGE_FOR_WIKIPEDIA_PEOPLE	SUBJECT_NAME:韩庚	ATTRIBUTE:家乡
韩庚是什么民族的	KNOWLEDGE_FOR_WIKIPEDIA_PEOPLE	SUBJECT_NAME:韩庚	ATTRIBUTE:民族
韩寒出生在什么年代	KNOWLEDGE_FOR_WIKIPEDIA_PEOPLE	SUBJECT_NAME:韩寒	ATTRIBUTE:出生
韩寒的年龄是多少	KNOWLEDGE_FOR_WIKIPEDIA_PEOPLE	SUBJECT_NAME:韩寒	ATTRIBUTE:年龄
韩寒的生日是哪一天	KNOWLEDGE_FOR_WIKIPEDIA_PEOPLE	SUBJECT_NAME:韩寒	ATTRIBUTE:生日
韩寒多大岁数了	KNOWLEDGE_FOR_WIKIPEDIA_PEOPLE	SUBJECT_NAME:韩寒	ATTRIBUTE:岁数
韩寒多少岁	KNOWLEDGE_FOR_WIKIPEDIA_PEOPLE	SUBJECT_NAME:韩寒	ATTRIBUTE:多少岁
韩寒多少岁了	KNOWLEDGE_FOR_WIKIPEDIA_PEOPLE	SUBJECT_NAME:韩寒	ATTRIBUTE:多少岁
韩寒今年多少岁	KNOWLEDGE_FOR_WIKIPEDIA_PEOPLE	SUBJECT_NAME:韩寒	YEAR_RANGE:今年	ATTRIBUTE:多少岁
韩寒现在多大了	KNOWLEDGE_FOR_WIKIPEDIA_PEOPLE	SUBJECT_NAME:韩寒	ATTRIBUTE:多大
韩寒有多高	KNOWLEDGE_FOR_WIKIPEDIA_PEOPLE	SUBJECT_NAME:韩寒	ATTRIBUTE:多高
韩寒有多老了	KNOWLEDGE_FOR_WIKIPEDIA_PEOPLE	SUBJECT_NAME:韩寒	ATTRIBUTE:多老
韩寒有什么作品	KNOWLEDGE_FOR_WIKIPEDIA_PEOPLE	SUBJECT_NAME:韩寒	ATTRIBUTE:作品
何炅是哪年出生的	KNOWLEDGE_FOR_WIKIPEDIA_PEOPLE	SUBJECT_NAME:何炅	ATTRIBUTE:出生
胡锦涛是哪年出生的	KNOWLEDGE_FOR_WIKIPEDIA_PEOPLE	SUBJECT_NAME:胡锦涛	ATTRIBUTE:出生
黄晓明多少岁了	KNOWLEDGE_FOR_WIKIPEDIA_PEOPLE	SUBJECT_NAME:黄晓明	ATTRIBUTE:多少岁
贾斯汀比伯的年龄是什么	KNOWLEDGE_FOR_WIKIPEDIA_PEOPLE	SUBJECT_NAME:贾斯汀比伯	ATTRIBUTE:年龄
贾斯汀比伯的身高是多少	KNOWLEDGE_FOR_WIKIPEDIA_PEOPLE	SUBJECT_NAME:贾斯汀比伯	ATTRIBUTE:身高
贾斯汀比伯多大年纪	KNOWLEDGE_FOR_WIKIPEDIA_PEOPLE	SUBJECT_NAME:贾斯汀比伯	ATTRIBUTE:年纪
今年韩寒多少岁	KNOWLEDGE_FOR_WIKIPEDIA_PEOPLE	YEAR_RANGE:今年	SUBJECT_NAME:韩寒	ATTRIBUTE:多少岁
科比有多高	KNOWLEDGE_FOR_WIKIPEDIA_PEOPLE	SUBJECT_NAME:科比	ATTRIBUTE:多高
李连杰多少岁了	KNOWLEDGE_FOR_WIKIPEDIA_PEOPLE	SUBJECT_NAME:李连杰	ATTRIBUTE:多少岁
李连杰来自什么地方	KNOWLEDGE_FOR_WIKIPEDIA_PEOPLE	SUBJECT_NAME:李连杰来自	ATTRIBUTE:来自
林肯多大年纪了	KNOWLEDGE_FOR_WIKIPEDIA_PEOPLE	SUBJECT_NAME:林肯	ATTRIBUTE:年纪
林肯是哪一年出生的	KNOWLEDGE_FOR_WIKIPEDIA_PEOPLE	SUBJECT_NAME:林肯	ATTRIBUTE:出生
林志颖多大了	KNOWLEDGE_FOR_WIKIPEDIA_PEOPLE	SUBJECT_NAME:林志颖	ATTRIBUTE:多大了
刘德华多大年纪了	KNOWLEDGE_FOR_WIKIPEDIA_PEOPLE	SUBJECT_NAME:刘德华	ATTRIBUTE:年纪
迈克尔杰克逊是什么时候出生的	KNOWLEDGE_FOR_WIKIPEDIA_PEOPLE	SUBJECT_NAME:迈克尔杰克逊	ATTRIBUTE:出生
迈克尔乔丹多大了	KNOWLEDGE_FOR_WIKIPEDIA_PEOPLE	SUBJECT_NAME:迈克尔乔丹	ATTRIBUTE:多大
麦当娜多大了	KNOWLEDGE_FOR_WIKIPEDIA_PEOPLE	SUBJECT_NAME:麦当娜	ATTRIBUTE:多大
麦莉塞勒斯多大了	KNOWLEDGE_FOR_WIKIPEDIA_PEOPLE	SUBJECT_NAME:麦莉塞勒斯	ATTRIBUTE:多大
米歇尔奥巴马多大了	KNOWLEDGE_FOR_WIKIPEDIA_PEOPLE	SUBJECT_NAME:米歇尔奥巴马	ATTRIBUTE:多大
哪一天是刘德华的生日	KNOWLEDGE_FOR_WIKIPEDIA_PEOPLE	SUBJECT_NAME:刘德华	ATTRIBUTE:生日
哪一天是韩寒的生日	KNOWLEDGE_FOR_WIKIPEDIA_PEOPLE	SUBJECT_NAME:韩寒	ATTRIBUTE:生日
强尼德普的故乡在哪里	KNOWLEDGE_FOR_WIKIPEDIA_PEOPLE	SUBJECT_NAME:强尼德普	ATTRIBUTE:故乡
尚雯婕多大了	KNOWLEDGE_FOR_WIKIPEDIA_PEOPLE	SUBJECT_NAME:尚雯婕	ATTRIBUTE:多大
谁和金卡戴珊约会	KNOWLEDGE_FOR_WIKIPEDIA_PEOPLE	SUBJECT_NAME:金卡戴珊	ATTRIBUTE:约会
威尔史密斯多大了	KNOWLEDGE_FOR_WIKIPEDIA_PEOPLE	SUBJECT_NAME:威尔史密斯	ATTRIBUTE:多大
习近平多大了	KNOWLEDGE_FOR_WIKIPEDIA_PEOPLE	SUBJECT_NAME:习近平	ATTRIBUTE:多大
习近平多少岁数	KNOWLEDGE_FOR_WIKIPEDIA_PEOPLE	SUBJECT_NAME:习近平	ATTRIBUTE:岁数
小布什的年龄是多少	KNOWLEDGE_FOR_WIKIPEDIA_PEOPLE	SUBJECT_NAME:小布什	ATTRIBUTE:年龄
小布什多大了	KNOWLEDGE_FOR_WIKIPEDIA_PEOPLE	SUBJECT_NAME:小布什	ATTRIBUTE:多大
小布什是哪一年出生的	KNOWLEDGE_FOR_WIKIPEDIA_PEOPLE	SUBJECT_NAME:小布什	ATTRIBUTE:出生
姚贝娜多大了	KNOWLEDGE_FOR_WIKIPEDIA_PEOPLE	SUBJECT_NAME:姚贝娜	ATTRIBUTE:多大
姚明到底有多高	KNOWLEDGE_FOR_WIKIPEDIA_PEOPLE	SUBJECT_NAME:姚明	ATTRIBUTE:多高
姚明的身高是多高	KNOWLEDGE_FOR_WIKIPEDIA_PEOPLE	SUBJECT_NAME:姚明	ATTRIBUTE:身高
姚明的身高是多少	KNOWLEDGE_FOR_WIKIPEDIA_PEOPLE	SUBJECT_NAME:姚明	ATTRIBUTE:身高
姚明多高	KNOWLEDGE_FOR_WIKIPEDIA_PEOPLE	SUBJECT_NAME:姚明	ATTRIBUTE:多高
姚明多少岁了	KNOWLEDGE_FOR_WIKIPEDIA_PEOPLE	SUBJECT_NAME:姚明	ATTRIBUTE:多少岁
姚明有多高	KNOWLEDGE_FOR_WIKIPEDIA_PEOPLE	SUBJECT_NAME:姚明	ATTRIBUTE:多高
约翰德普的年龄是多少	KNOWLEDGE_FOR_WIKIPEDIA_PEOPLE	SUBJECT_NAME:约翰德普	ATTRIBUTE:年龄
约翰德普多大了	KNOWLEDGE_FOR_WIKIPEDIA_PEOPLE	SUBJECT_NAME:约翰德普	ATTRIBUTE:多大
约翰德普有得过奥斯卡吗	KNOWLEDGE_FOR_WIKIPEDIA_PEOPLE	SUBJECT_NAME:约翰德普	ATTRIBUTE:奥斯卡
詹姆斯有多高	KNOWLEDGE_FOR_WIKIPEDIA_PEOPLE	SUBJECT_NAME:詹姆斯	ATTRIBUTE:多高
张学友的身高是多少	KNOWLEDGE_FOR_WIKIPEDIA_PEOPLE	SUBJECT_NAME:张学友	ATTRIBUTE:身高
张学友多大了	KNOWLEDGE_FOR_WIKIPEDIA_PEOPLE	SUBJECT_NAME:张学友	ATTRIBUTE:多大
张学友多大年纪了	KNOWLEDGE_FOR_WIKIPEDIA_PEOPLE	SUBJECT_NAME:张学友	ATTRIBUTE:年纪
张学友多大岁数了	KNOWLEDGE_FOR_WIKIPEDIA_PEOPLE	SUBJECT_NAME:张学友	ATTRIBUTE:岁数
赵薇多大	KNOWLEDGE_FOR_WIKIPEDIA_PEOPLE	SUBJECT_NAME:赵薇	ATTRIBUTE:多大
赵薇多大了	KNOWLEDGE_FOR_WIKIPEDIA_PEOPLE	SUBJECT_NAME:赵薇	ATTRIBUTE:多大
赵薇多少岁了	KNOWLEDGE_FOR_WIKIPEDIA_PEOPLE	SUBJECT_NAME:赵薇	ATTRIBUTE:多少岁
赵薇今年多少岁	KNOWLEDGE_FOR_WIKIPEDIA_PEOPLE	SUBJECT_NAME:赵薇	YEAR_RANGE:今年	ATTRIBUTE:多少岁
赵薇现在多大了	KNOWLEDGE_FOR_WIKIPEDIA_PEOPLE	SUBJECT_NAME:赵薇	ATTRIBUTE:多大
周杰伦多大了	KNOWLEDGE_FOR_WIKIPEDIA_PEOPLE	SUBJECT_NAME:周杰伦	ATTRIBUTE:多大
主席多大了	KNOWLEDGE_FOR_WIKIPEDIA_PEOPLE	SUBJECT_NAME:主席	ATTRIBUTE:多大
贾斯汀比伯多大了	KNOWLEDGE_FOR_WIKIPEDIA_PEOPLE	SUBJECT_NAME:贾斯汀比伯	ATTRIBUTE:多大
迈克尔杰克逊去世于哪一年	KNOWLEDGE_FOR_WIKIPEDIA_PEOPLE	SUBJECT_NAME:迈克尔杰克逊	ATTRIBUTE:去世
迈克尔杰克逊在哪一年去世	KNOWLEDGE_FOR_WIKIPEDIA_PEOPLE	SUBJECT_NAME:迈克尔杰克逊	ATTRIBUTE:去世
马丁路德金多大了	KNOWLEDGE_FOR_WIKIPEDIA_PEOPLE	SUBJECT_NAME:马丁路德金	ATTRIBUTE:多大
赵薇的家乡在哪里	KNOWLEDGE_FOR_WIKIPEDIA_PEOPLE	SUBJECT_NAME:赵薇	ATTRIBUTE:家乡
谁是赵薇的丈夫	KNOWLEDGE_FOR_WIKIPEDIA_PEOPLE	SUBJECT_NAME:赵薇	ATTRIBUTE:丈夫
赵薇结婚了吗	KNOWLEDGE_FOR_WIKIPEDIA_PEOPLE	SUBJECT_NAME:赵薇	ATTRIBUTE:结婚
赵薇的成名作是什么	KNOWLEDGE_FOR_WIKIPEDIA_PEOPLE	SUBJECT_NAME:赵薇	ATTRIBUTE:成名作
赵薇获得过哪些奖项	KNOWLEDGE_FOR_WIKIPEDIA_PEOPLE	SUBJECT_NAME:赵薇	ATTRIBUTE:奖项
赵薇的女儿几岁了	KNOWLEDGE_FOR_WIKIPEDIA_PEOPLE	SUBJECT_NAME:赵薇	ATTRIBUTE:女儿
赵薇现在还是中国国籍吗	KNOWLEDGE_FOR_WIKIPEDIA_PEOPLE	SUBJECT_NAME:赵薇	STATE:中国	ATTRIBUTE:国籍
赵薇得过几次金鸡奖	KNOWLEDGE_FOR_WIKIPEDIA_PEOPLE	SUBJECT_NAME:赵薇	ATTRIBUTE:金鸡奖
赵薇是哪一年结婚的	KNOWLEDGE_FOR_WIKIPEDIA_PEOPLE	SUBJECT_NAME:赵薇	ATTRIBUTE:结婚
赵薇有什么信仰吗	KNOWLEDGE_FOR_WIKIPEDIA_PEOPLE	SUBJECT_NAME:赵薇	ATTRIBUTE:信仰
赵薇是哪里人	KNOWLEDGE_FOR_WIKIPEDIA_PEOPLE	SUBJECT_NAME:赵薇	ATTRIBUTE:哪里人
孙杨有多高	KNOWLEDGE_FOR_WIKIPEDIA_PEOPLE	SUBJECT_NAME:孙杨	ATTRIBUTE:多高
林丹有多高啊	KNOWLEDGE_FOR_WIKIPEDIA_PEOPLE	SUBJECT_NAME:林丹	ATTRIBUTE:多高
吉姆伯赫姆有多高	KNOWLEDGE_FOR_WIKIPEDIA_PEOPLE	SUBJECT_NAME:吉姆伯赫姆	ATTRIBUTE:多高
吉姆卡尔霍恩有多重	KNOWLEDGE_FOR_WIKIPEDIA_PEOPLE	SUBJECT_NAME:吉姆卡尔霍恩	ATTRIBUTE:多重
史迪维禾比根是哪里出生的	KNOWLEDGE_FOR_WIKIPEDIA_PEOPLE	SUBJECT_NAME:史迪维禾比根	ATTRIBUTE:出生
史蒂文卡尔科勒家乡是不是在英国	KNOWLEDGE_FOR_WIKIPEDIA_PEOPLE	SUBJECT_NAME:史蒂文卡尔科勒	ATTRIBUTE:家乡	STATE:英国
卢卡斯波多尔斯基的体重	KNOWLEDGE_FOR_WIKIPEDIA_PEOPLE	SUBJECT_NAME:卢卡斯波多尔斯基	ATTRIBUTE:体重
卢卡莫德里奇的体重是什么	KNOWLEDGE_FOR_WIKIPEDIA_PEOPLE	SUBJECT_NAME:卢卡莫德里奇	ATTRIBUTE:体重
告诉我曼努埃尔卢塞纳的生日	KNOWLEDGE_FOR_WIKIPEDIA_PEOPLE	SUBJECT_NAME:曼努埃尔卢塞纳	ATTRIBUTE:生日
告诉我格伦约翰逊个子有多高	KNOWLEDGE_FOR_WIKIPEDIA_PEOPLE	SUBJECT_NAME:格伦约翰逊	ATTRIBUTE:多高
告诉我迈克尔欧文有多重	KNOWLEDGE_FOR_WIKIPEDIA_PEOPLE	SUBJECT_NAME:迈克尔欧文	ATTRIBUTE:多重
告诉我陈荣兴的年龄	KNOWLEDGE_FOR_WIKIPEDIA_PEOPLE	SUBJECT_NAME:陈荣兴	ATTRIBUTE:年龄
埃德森布拉夫海德的出生日期是什么	KNOWLEDGE_FOR_WIKIPEDIA_PEOPLE	SUBJECT_NAME:埃德森布拉夫海德	ATTRIBUTE:出生日期
域陀华迪斯这个人有多重	KNOWLEDGE_FOR_WIKIPEDIA_PEOPLE	SUBJECT_NAME:域陀华迪斯	ATTRIBUTE:多重
埃曼努埃尔弗里庞来自于什么地区	KNOWLEDGE_FOR_WIKIPEDIA_PEOPLE	SUBJECT_NAME:埃曼努埃尔弗里庞	ATTRIBUTE:地区
埃曼纽埃尔埃布埃国籍是什么	KNOWLEDGE_FOR_WIKIPEDIA_PEOPLE	SUBJECT_NAME:埃曼纽埃尔埃布埃	ATTRIBUTE:国籍
塞巴斯蒂安科茨有多重	KNOWLEDGE_FOR_WIKIPEDIA_PEOPLE	SUBJECT_NAME:塞巴斯蒂安科茨	ATTRIBUTE:多重
塞巴斯蒂安弗赖是哪里人	KNOWLEDGE_FOR_WIKIPEDIA_PEOPLE	SUBJECT_NAME:塞巴斯蒂安弗赖	ATTRIBUTE:哪里人
基隆代尔的身高体重各是多少	KNOWLEDGE_FOR_WIKIPEDIA_PEOPLE	SUBJECT_NAME:基隆代尔	ATTRIBUTE:身高	ATTRIBUTE:体重
塞斯克法比加斯来自哪个地区	KNOWLEDGE_FOR_WIKIPEDIA_PEOPLE	SUBJECT_NAME:塞斯克法比加斯	ATTRIBUTE:地区
姚明身高多少	KNOWLEDGE_FOR_WIKIPEDIA_PEOPLE	SUBJECT_NAME:姚明	ATTRIBUTE:身高
姚明身高如何	KNOWLEDGE_FOR_WIKIPEDIA_PEOPLE	SUBJECT_NAME:姚明	ATTRIBUTE:身高
姚明的身高是不是在两米二左右	KNOWLEDGE_FOR_WIKIPEDIA_PEOPLE	SUBJECT_NAME:姚明	ATTRIBUTE:身高
威廉鲍威尔是谁	KNOWLEDGE_FOR_WIKIPEDIA_PEOPLE	SUBJECT_NAME:威廉鲍威尔
孙兴民的个人资料	KNOWLEDGE_FOR_WIKIPEDIA_PEOPLE	SUBJECT_NAME:孙兴民
安德鲁卡罗尔在什么地方出生的	KNOWLEDGE_FOR_WIKIPEDIA_PEOPLE	SUBJECT_NAME:安德鲁卡罗尔	ATTRIBUTE:出生
尼尔森是个什么样的人	KNOWLEDGE_FOR_WIKIPEDIA_PEOPLE	SUBJECT_NAME:尼尔森
巴特利庄臣现在已经多少岁了	KNOWLEDGE_FOR_WIKIPEDIA_PEOPLE	SUBJECT_NAME:巴特利庄臣	ATTRIBUTE:多少岁
布雷克格里芬的年龄有多大	KNOWLEDGE_FOR_WIKIPEDIA_PEOPLE	SUBJECT_NAME:布雷克格里芬	ATTRIBUTE:年龄
巴斯蒂安施魏因斯泰格几岁了	KNOWLEDGE_FOR_WIKIPEDIA_PEOPLE	SUBJECT_NAME:巴斯蒂安施魏因斯泰格	ATTRIBUTE:几岁
彼得克劳奇的生日是几月几号	KNOWLEDGE_FOR_WIKIPEDIA_PEOPLE	SUBJECT_NAME:彼得克劳奇	ATTRIBUTE:生日
彼得奥丹维治的生日在哪天	KNOWLEDGE_FOR_WIKIPEDIA_PEOPLE	SUBJECT_NAME:彼得奥丹维治	ATTRIBUTE:生日
德克博里赫特的个人资料告诉我	KNOWLEDGE_FOR_WIKIPEDIA_PEOPLE	SUBJECT_NAME:德克博里赫特
德克诺维茨基的体重是多少斤	KNOWLEDGE_FOR_WIKIPEDIA_PEOPLE	SUBJECT_NAME:德克诺维茨基	ATTRIBUTE:体重
德怀特霍华德的国籍	KNOWLEDGE_FOR_WIKIPEDIA_PEOPLE	SUBJECT_NAME:德怀特霍华德	ATTRIBUTE:国籍
德拉赞皮特洛维奇的年龄是什么	KNOWLEDGE_FOR_WIKIPEDIA_PEOPLE	SUBJECT_NAME:德拉赞皮特洛维奇	ATTRIBUTE:年龄
拉什的体重大约有多少磅	KNOWLEDGE_FOR_WIKIPEDIA_PEOPLE	SUBJECT_NAME:拉什	ATTRIBUTE:体重
拉什大约有多少磅重	KNOWLEDGE_FOR_WIKIPEDIA_PEOPLE	SUBJECT_NAME:拉什	ATTRIBUTE:重
拉塞尔威斯布鲁克重几磅	KNOWLEDGE_FOR_WIKIPEDIA_PEOPLE	SUBJECT_NAME:拉塞尔威斯布鲁克	ATTRIBUTE:重
拿祖蒙利尔的国籍是英国么	KNOWLEDGE_FOR_WIKIPEDIA_PEOPLE	SUBJECT_NAME:拿祖蒙利尔	ATTRIBUTE:国籍	STATE:英国
杰克科里森来自于什么国家	KNOWLEDGE_FOR_WIKIPEDIA_PEOPLE	SUBJECT_NAME:杰克科里森	ATTRIBUTE:国家
王凯是哪里人	KNOWLEDGE_FOR_WIKIPEDIA_PEOPLE	SUBJECT_NAME:王凯	ATTRIBUTE:哪里人
瑞安怀特几月几日生	KNOWLEDGE_FOR_WIKIPEDIA_PEOPLE	SUBJECT_NAME:瑞安怀特	ATTRIBUTE:生
米克尔莱格伍德的出生地点是什么	KNOWLEDGE_FOR_WIKIPEDIA_PEOPLE	SUBJECT_NAME:米克尔莱格伍德	ATTRIBUTE:出生地点
把史玉柱的生日告诉我	KNOWLEDGE_FOR_WIKIPEDIA_PEOPLE	SUBJECT_NAME:史玉柱	ATTRIBUTE:生日
纳丘蒙雷亚尔的年龄是不是比较大了	KNOWLEDGE_FOR_WIKIPEDIA_PEOPLE	SUBJECT_NAME:纳丘蒙雷亚尔	ATTRIBUTE:年龄
杰梅恩迪福是什么年代出生的	KNOWLEDGE_FOR_WIKIPEDIA_PEOPLE	SUBJECT_NAME:杰梅恩迪福	ATTRIBUTE:出生
毛罗博塞利多高多重	KNOWLEDGE_FOR_WIKIPEDIA_PEOPLE	SUBJECT_NAME:毛罗博塞利	ATTRIBUTE:高	ATTRIBUTE:重
维安斯特林格高几英尺几英寸	KNOWLEDGE_FOR_WIKIPEDIA_PEOPLE	SUBJECT_NAME:维安斯特林格	ATTRIBUTE:高
罗伊威廉姆斯是从哪里来	KNOWLEDGE_FOR_WIKIPEDIA_PEOPLE	SUBJECT_NAME:罗伊威廉姆斯
说一说任正非的生日	KNOWLEDGE_FOR_WIKIPEDIA_PEOPLE	SUBJECT_NAME:任正非	ATTRIBUTE:生日
把古永锵的生日说一说	KNOWLEDGE_FOR_WIKIPEDIA_PEOPLE	SUBJECT_NAME:古永锵	ATTRIBUTE:生日
罗德里戈来自于什么城市	KNOWLEDGE_FOR_WIKIPEDIA_PEOPLE	SUBJECT_NAME:罗德里戈	ATTRIBUTE:城市
罗恩罗伯特齐勒是哪国人	KNOWLEDGE_FOR_WIKIPEDIA_PEOPLE	SUBJECT_NAME:罗恩罗伯特齐勒	ATTRIBUTE:哪国人
罗曼帕夫柳琴科来自哪个国家	KNOWLEDGE_FOR_WIKIPEDIA_PEOPLE	SUBJECT_NAME:罗曼帕夫柳琴科	ATTRIBUTE:国家
美因茨身高有几厘米	KNOWLEDGE_FOR_WIKIPEDIA_PEOPLE	SUBJECT_NAME:美因茨	ATTRIBUTE:身高
把龚宇的生日找出来	KNOWLEDGE_FOR_WIKIPEDIA_PEOPLE	SUBJECT_NAME:龚宇	ATTRIBUTE:生日
胡安贝尔纳特的家乡是哪里	KNOWLEDGE_FOR_WIKIPEDIA_PEOPLE	SUBJECT_NAME:胡安贝尔纳特	ATTRIBUTE:家乡
苏冈特这个运动员有多胖	KNOWLEDGE_FOR_WIKIPEDIA_PEOPLE	SUBJECT_NAME:苏冈特	ATTRIBUTE:多胖
张朝阳的生日被找出来	KNOWLEDGE_FOR_WIKIPEDIA_PEOPLE	SUBJECT_NAME:张朝阳	ATTRIBUTE:生日
范钱斯勒是从什么国家来的	KNOWLEDGE_FOR_WIKIPEDIA_PEOPLE	SUBJECT_NAME:范钱斯勒	ATTRIBUTE:国家
马上把柳传志的生日调出来	KNOWLEDGE_FOR_WIKIPEDIA_PEOPLE	SUBJECT_NAME:柳传志	ATTRIBUTE:生日
莫迪保迪亚基特现在的年龄	KNOWLEDGE_FOR_WIKIPEDIA_PEOPLE	SUBJECT_NAME:莫迪保迪亚基特	ATTRIBUTE:年龄
周鸿祎的生日被调出来	KNOWLEDGE_FOR_WIKIPEDIA_PEOPLE	SUBJECT_NAME:周鸿祎	ATTRIBUTE:生日
菲利普拉姆国籍是哪里	KNOWLEDGE_FOR_WIKIPEDIA_PEOPLE	SUBJECT_NAME:菲利普拉姆	ATTRIBUTE:国籍
来一个李彦宏的生日	KNOWLEDGE_FOR_WIKIPEDIA_PEOPLE	SUBJECT_NAME:李彦宏	ATTRIBUTE:生日
道格里弗斯的生日是什么时候	KNOWLEDGE_FOR_WIKIPEDIA_PEOPLE	SUBJECT_NAME:道格里弗斯	ATTRIBUTE:生日
马化腾的生日是多少	KNOWLEDGE_FOR_WIKIPEDIA_PEOPLE	SUBJECT_NAME:马化腾	ATTRIBUTE:生日
门迪兰多夫的出生地在什么地方	KNOWLEDGE_FOR_WIKIPEDIA_PEOPLE	SUBJECT_NAME:门迪兰多夫	ATTRIBUTE:出生地
麦蒂年龄如何	KNOWLEDGE_FOR_WIKIPEDIA_PEOPLE	SUBJECT_NAME:麦蒂	ATTRIBUTE:年龄
亲，马云的生日	KNOWLEDGE_FOR_WIKIPEDIA_PEOPLE	SUBJECT_NAME:马云	ATTRIBUTE:生日
告诉我朱茵的生日	KNOWLEDGE_FOR_WIKIPEDIA_PEOPLE	SUBJECT_NAME:朱茵	ATTRIBUTE:生日
找出周星驰的生日	KNOWLEDGE_FOR_WIKIPEDIA_PEOPLE	SUBJECT_NAME:周星驰	ATTRIBUTE:生日
王宝强生日给我找出来	KNOWLEDGE_FOR_WIKIPEDIA_PEOPLE	SUBJECT_NAME:王宝强	ATTRIBUTE:生日
喂，我要刘涛的生日	KNOWLEDGE_FOR_WIKIPEDIA_PEOPLE	SUBJECT_NAME:刘涛	ATTRIBUTE:生日
马上给我找到赵黎明的生日	KNOWLEDGE_FOR_WIKIPEDIA_PEOPLE	SUBJECT_NAME:赵黎明	ATTRIBUTE:生日
能告诉我孙俪的生日吗	KNOWLEDGE_FOR_WIKIPEDIA_PEOPLE	SUBJECT_NAME:孙俪	ATTRIBUTE:生日
能找出邓超的生日吗	KNOWLEDGE_FOR_WIKIPEDIA_PEOPLE	SUBJECT_NAME:邓超	ATTRIBUTE:生日
李晨生日能给我找出来吗	KNOWLEDGE_FOR_WIKIPEDIA_PEOPLE	SUBJECT_NAME:李晨	ATTRIBUTE:生日
喂，我能要周杰伦的生日吗	KNOWLEDGE_FOR_WIKIPEDIA_PEOPLE	SUBJECT_NAME:周杰伦	ATTRIBUTE:生日
能马上给我找到黄晓明的生日吗	KNOWLEDGE_FOR_WIKIPEDIA_PEOPLE	SUBJECT_NAME:黄晓明	ATTRIBUTE:生日
那个罗大佑的生日是多少呢	KNOWLEDGE_FOR_WIKIPEDIA_PEOPLE	SUBJECT_NAME:罗大佑	ATTRIBUTE:生日
亲，张学友能给个生日吗	KNOWLEDGE_FOR_WIKIPEDIA_PEOPLE	SUBJECT_NAME:张学友	ATTRIBUTE:生日
李斌的生日能被查询吗	KNOWLEDGE_FOR_WIKIPEDIA_PEOPLE	SUBJECT_NAME:李斌	ATTRIBUTE:生日
蒋秦天的生日是几号？	KNOWLEDGE_FOR_WIKIPEDIA_PEOPLE	SUBJECT_NAME:蒋秦天	ATTRIBUTE:生日
我想知道强森什么时候过生日	KNOWLEDGE_FOR_WIKIPEDIA_PEOPLE	ATTRIBUTE:生日
习近平书记的生日是几号	KNOWLEDGE_FOR_WIKIPEDIA_PEOPLE	SUBJECT_NAME:习近平书记	ATTRIBUTE:生日
搜一下聂卫平的生日	KNOWLEDGE_FOR_WIKIPEDIA_PEOPLE	SUBJECT_NAME:聂卫平	ATTRIBUTE:生日
请跟我说下李鹏的生日日期	KNOWLEDGE_FOR_WIKIPEDIA_PEOPLE	SUBJECT_NAME:李鹏	ATTRIBUTE:生日日期
联系人孙红雷的生日是几号来着？	KNOWLEDGE_FOR_WIKIPEDIA_PEOPLE	SUBJECT_NAME:孙红雷	ATTRIBUTE:生日
有没有惠凤娇的生日帮我看下	KNOWLEDGE_FOR_WIKIPEDIA_PEOPLE	SUBJECT_NAME:惠凤娇	ATTRIBUTE:生日
我的室友威廉的生日是几号	KNOWLEDGE_FOR_WIKIPEDIA_PEOPLE	SUBJECT_NAME:室友威廉	ATTRIBUTE:生日
找到李潇潇的生日	KNOWLEDGE_FOR_WIKIPEDIA_PEOPLE	SUBJECT_NAME:李潇潇	ATTRIBUTE:生日
给我拿来浩东的生日	KNOWLEDGE_FOR_WIKIPEDIA_PEOPLE	SUBJECT_NAME:浩东	ATTRIBUTE:生日
我要瞄一眼君豪的生日	KNOWLEDGE_FOR_WIKIPEDIA_PEOPLE	SUBJECT_NAME:君豪	ATTRIBUTE:生日
姜哲俊的生日是什么时候	KNOWLEDGE_FOR_WIKIPEDIA_PEOPLE	SUBJECT_NAME:姜哲俊	ATTRIBUTE:生日
哪一天才是姜哲俊的生日	KNOWLEDGE_FOR_WIKIPEDIA_PEOPLE	SUBJECT_NAME:姜哲俊	ATTRIBUTE:生日
几月几号是姜哲俊生日	KNOWLEDGE_FOR_WIKIPEDIA_PEOPLE	SUBJECT_NAME:姜哲俊	ATTRIBUTE:生日
我想要知道姜哲俊的生日	KNOWLEDGE_FOR_WIKIPEDIA_PEOPLE	SUBJECT_NAME:姜哲俊	ATTRIBUTE:生日
告诉我姜哲俊的生日	KNOWLEDGE_FOR_WIKIPEDIA_PEOPLE	SUBJECT_NAME:姜哲俊	ATTRIBUTE:生日
能否告知我姜哲俊的生日	KNOWLEDGE_FOR_WIKIPEDIA_PEOPLE	SUBJECT_NAME:姜哲俊	ATTRIBUTE:生日
我需要知道姜哲俊的生日	KNOWLEDGE_FOR_WIKIPEDIA_PEOPLE	SUBJECT_NAME:姜哲俊	ATTRIBUTE:生日
姜哲俊生日几月几号	KNOWLEDGE_FOR_WIKIPEDIA_PEOPLE	SUBJECT_NAME:姜哲俊	ATTRIBUTE:生日
哪天才是姜哲俊生日啊	KNOWLEDGE_FOR_WIKIPEDIA_PEOPLE	SUBJECT_NAME:姜哲俊	ATTRIBUTE:生日
姜哲俊哪天过生日	KNOWLEDGE_FOR_WIKIPEDIA_PEOPLE	SUBJECT_NAME:姜哲俊	ATTRIBUTE:生日
姜哲俊哪天生的	KNOWLEDGE_FOR_WIKIPEDIA_PEOPLE	SUBJECT_NAME:姜哲俊	ATTRIBUTE:生的
姜哲俊几月几号生的	KNOWLEDGE_FOR_WIKIPEDIA_PEOPLE	SUBJECT_NAME:姜哲俊	ATTRIBUTE:生的
姜哲俊何年何月何日生	KNOWLEDGE_FOR_WIKIPEDIA_PEOPLE	SUBJECT_NAME:姜哲俊	ATTRIBUTE:何年何月何日生
姜哲俊是什么时候生的	KNOWLEDGE_FOR_WIKIPEDIA_PEOPLE	SUBJECT_NAME:姜哲俊	ATTRIBUTE:生
姜哲俊的生日什么时候过	KNOWLEDGE_FOR_WIKIPEDIA_PEOPLE	SUBJECT_NAME:姜哲俊	ATTRIBUTE:生日
给我说姜哲俊的生日	KNOWLEDGE_FOR_WIKIPEDIA_PEOPLE	SUBJECT_NAME:姜哲俊	ATTRIBUTE:生日
我需要姜哲俊的生日	KNOWLEDGE_FOR_WIKIPEDIA_PEOPLE	SUBJECT_NAME:姜哲俊	ATTRIBUTE:生日
哪一天是姜哲俊的生日	KNOWLEDGE_FOR_WIKIPEDIA_PEOPLE	SUBJECT_NAME:姜哲俊	ATTRIBUTE:生日
姜哲俊是哪一天生日	KNOWLEDGE_FOR_WIKIPEDIA_PEOPLE	SUBJECT_NAME:姜哲俊	ATTRIBUTE:生日
姜哲俊过生日是哪一天	KNOWLEDGE_FOR_WIKIPEDIA_PEOPLE	SUBJECT_NAME:姜哲俊	ATTRIBUTE:生日
请显示姜哲俊的生日	KNOWLEDGE_FOR_WIKIPEDIA_PEOPLE	SUBJECT_NAME:姜哲俊	ATTRIBUTE:生日
能不能告诉我姜哲俊哪天生日	KNOWLEDGE_FOR_WIKIPEDIA_PEOPLE	SUBJECT_NAME:姜哲俊	ATTRIBUTE:生日
我想要了解姜哲俊的生日	KNOWLEDGE_FOR_WIKIPEDIA_PEOPLE	SUBJECT_NAME:姜哲俊	ATTRIBUTE:生日
快说哪一天是姜哲俊的生日	KNOWLEDGE_FOR_WIKIPEDIA_PEOPLE	SUBJECT_NAME:姜哲俊	ATTRIBUTE:生日
帮我找到姜哲俊的生日	KNOWLEDGE_FOR_WIKIPEDIA_PEOPLE	SUBJECT_NAME:姜哲俊	ATTRIBUTE:生日
姜哲俊的生日是哪一天	KNOWLEDGE_FOR_WIKIPEDIA_PEOPLE	SUBJECT_NAME:姜哲俊	ATTRIBUTE:生日
我要知道姜哲俊的生日	KNOWLEDGE_FOR_WIKIPEDIA_PEOPLE	SUBJECT_NAME:姜哲俊	ATTRIBUTE:生日
姜哲俊是哪天生的	KNOWLEDGE_FOR_WIKIPEDIA_PEOPLE	SUBJECT_NAME:姜哲俊	ATTRIBUTE:生的
我想查找姜哲俊的生日	KNOWLEDGE_FOR_WIKIPEDIA_PEOPLE	SUBJECT_NAME:姜哲俊	ATTRIBUTE:生日
能告诉我姜哲俊生日吗	KNOWLEDGE_FOR_WIKIPEDIA_PEOPLE	SUBJECT_NAME:姜哲俊	ATTRIBUTE:生日
姜哲俊生日的日期是什么	KNOWLEDGE_FOR_WIKIPEDIA_PEOPLE	SUBJECT_NAME:姜哲俊	ATTRIBUTE:生日
什么日期是姜哲俊的生日	KNOWLEDGE_FOR_WIKIPEDIA_PEOPLE	SUBJECT_NAME:姜哲俊	ATTRIBUTE:生日
姜哲俊几号生日	KNOWLEDGE_FOR_WIKIPEDIA_PEOPLE	SUBJECT_NAME:姜哲俊	ATTRIBUTE:生日
姜哲俊生日是啥时候	KNOWLEDGE_FOR_WIKIPEDIA_PEOPLE	SUBJECT_NAME:姜哲俊	ATTRIBUTE:生日
几月几号姜哲俊过生日	KNOWLEDGE_FOR_WIKIPEDIA_PEOPLE	SUBJECT_NAME:姜哲俊	ATTRIBUTE:生日
告诉我姜哲俊几月几号生日	KNOWLEDGE_FOR_WIKIPEDIA_PEOPLE	SUBJECT_NAME:姜哲俊	ATTRIBUTE:生日
帮我查询姜哲俊的生日	KNOWLEDGE_FOR_WIKIPEDIA_PEOPLE	SUBJECT_NAME:姜哲俊	ATTRIBUTE:生日
给我找出来姜哲俊的生日	KNOWLEDGE_FOR_WIKIPEDIA_PEOPLE	SUBJECT_NAME:姜哲俊	ATTRIBUTE:生日
姜哲俊生日请帮我找到	KNOWLEDGE_FOR_WIKIPEDIA_PEOPLE	SUBJECT_NAME:姜哲俊	ATTRIBUTE:生日
可以帮我查询姜哲俊生日吗	KNOWLEDGE_FOR_WIKIPEDIA_PEOPLE	SUBJECT_NAME:姜哲俊	ATTRIBUTE:生日
给我姜哲俊生日	KNOWLEDGE_FOR_WIKIPEDIA_PEOPLE	SUBJECT_NAME:姜哲俊	ATTRIBUTE:生日
给我从西藏来的三哥的生日	KNOWLEDGE_FOR_WIKIPEDIA_PEOPLE	PROVINCE:西藏	SUBJECT_NAME:三哥	ATTRIBUTE:生日
住在山东的孙总生日？	KNOWLEDGE_FOR_WIKIPEDIA_PEOPLE	PROVINCE:山东	SUBJECT_NAME:孙总	ATTRIBUTE:生日
我要瞅下大峰的生日是几号	KNOWLEDGE_FOR_WIKIPEDIA_PEOPLE	SUBJECT_NAME:大峰	ATTRIBUTE:生日
我问你邓副主任的出生日期几月几号	KNOWLEDGE_FOR_WIKIPEDIA_PEOPLE	SUBJECT_NAME:邓副主任	ATTRIBUTE:出生日期
话说于禹潞的出生日期礼拜几	KNOWLEDGE_FOR_WIKIPEDIA_PEOPLE	SUBJECT_NAME:于禹潞	ATTRIBUTE:出生日期
给我说老王的生日礼拜几	KNOWLEDGE_FOR_WIKIPEDIA_PEOPLE	SUBJECT_NAME:老王	ATTRIBUTE:生日
查查龙金锘的生日几月几号	KNOWLEDGE_FOR_WIKIPEDIA_PEOPLE	SUBJECT_NAME:龙金锘	ATTRIBUTE:生日
程建华的生日啥时候	KNOWLEDGE_FOR_WIKIPEDIA_PEOPLE	SUBJECT_NAME:程建华	ATTRIBUTE:生日
张夫人的出生日期星期几	KNOWLEDGE_FOR_WIKIPEDIA_PEOPLE	SUBJECT_NAME:张夫人	ATTRIBUTE:出生日期
手机显示谭市长的生日哪一天	KNOWLEDGE_FOR_WIKIPEDIA_PEOPLE	SUBJECT_NAME:谭市长	ATTRIBUTE:生日
给我谭院长的生日几月几号	KNOWLEDGE_FOR_WIKIPEDIA_PEOPLE	SUBJECT_NAME:谭院长	ATTRIBUTE:生日
给我显示段长官的出生日期几号	KNOWLEDGE_FOR_WIKIPEDIA_PEOPLE	SUBJECT_NAME:段长官	ATTRIBUTE:出生日期
钱衍桐的生日什么时候	KNOWLEDGE_FOR_WIKIPEDIA_PEOPLE	SUBJECT_NAME:钱衍桐	ATTRIBUTE:生日
小艹的生日是礼拜几	KNOWLEDGE_FOR_WIKIPEDIA_PEOPLE	SUBJECT_NAME:小艹	ATTRIBUTE:生日
跟我说赵博士的生日是哪天	KNOWLEDGE_FOR_WIKIPEDIA_PEOPLE	SUBJECT_NAME:赵博士	ATTRIBUTE:生日
金科长的生日是啥时候	KNOWLEDGE_FOR_WIKIPEDIA_PEOPLE	SUBJECT_NAME:金科长	ATTRIBUTE:生日
李立林的生日是几号	KNOWLEDGE_FOR_WIKIPEDIA_PEOPLE	SUBJECT_NAME:李立林	ATTRIBUTE:生日
张夫人的生日是几号	KNOWLEDGE_FOR_WIKIPEDIA_PEOPLE	SUBJECT_NAME:张夫人	ATTRIBUTE:生日
王副主任的生日是哪一天	KNOWLEDGE_FOR_WIKIPEDIA_PEOPLE	SUBJECT_NAME:王副主任	ATTRIBUTE:生日
甘铁生的出生日期是几月几号	KNOWLEDGE_FOR_WIKIPEDIA_PEOPLE	SUBJECT_NAME:甘铁生	ATTRIBUTE:出生日期
给我李队员的出生日期是星期几	KNOWLEDGE_FOR_WIKIPEDIA_PEOPLE	SUBJECT_NAME:李队员	ATTRIBUTE:出生日期
郑前辈的生日是星期几	KNOWLEDGE_FOR_WIKIPEDIA_PEOPLE	SUBJECT_NAME:郑前辈	ATTRIBUTE:生日
老陆的生日是星期几	KNOWLEDGE_FOR_WIKIPEDIA_PEOPLE	SUBJECT_NAME:老陆	ATTRIBUTE:生日
大妈的生日是哪一天	KNOWLEDGE_FOR_WIKIPEDIA_PEOPLE	SUBJECT_NAME:大妈	ATTRIBUTE:生日
叶叶的生日是星期几	KNOWLEDGE_FOR_WIKIPEDIA_PEOPLE	SUBJECT_NAME:叶叶	ATTRIBUTE:生日
格格的生日是几号	KNOWLEDGE_FOR_WIKIPEDIA_PEOPLE	SUBJECT_NAME:格格	ATTRIBUTE:生日
查找丧病王的出生日期是啥时候	KNOWLEDGE_FOR_WIKIPEDIA_PEOPLE	SUBJECT_NAME:丧病王	ATTRIBUTE:出生日期
哼哼的生日是几号	KNOWLEDGE_FOR_WIKIPEDIA_PEOPLE	SUBJECT_NAME:哼哼	ATTRIBUTE:生日
鸽子的生日是礼拜几	KNOWLEDGE_FOR_WIKIPEDIA_PEOPLE	SUBJECT_NAME:鸽子	ATTRIBUTE:生日
花妞的出生日期是哪天	KNOWLEDGE_FOR_WIKIPEDIA_PEOPLE	SUBJECT_NAME:花妞	ATTRIBUTE:出生日期
查查波波的生日是礼拜几	KNOWLEDGE_FOR_WIKIPEDIA_PEOPLE	SUBJECT_NAME:波波	ATTRIBUTE:生日
话说月球哥的出生日期是啥时候	KNOWLEDGE_FOR_WIKIPEDIA_PEOPLE	SUBJECT_NAME:月球哥	ATTRIBUTE:出生日期
请你找托尼马森博格的身高	KNOWLEDGE_FOR_WIKIPEDIA_PEOPLE	SUBJECT_NAME:托尼马森博格	ATTRIBUTE:身高
我问你琳琳的生日是几号	KNOWLEDGE_FOR_WIKIPEDIA_PEOPLE	SUBJECT_NAME:琳琳	ATTRIBUTE:生日
搜寻伦辛的身高	KNOWLEDGE_FOR_WIKIPEDIA_PEOPLE	SUBJECT_NAME:伦辛	ATTRIBUTE:身高
找一下伊恩的家乡	KNOWLEDGE_FOR_WIKIPEDIA_PEOPLE	SUBJECT_NAME:伊恩	ATTRIBUTE:家乡
话说于禹的出生日期礼拜几	KNOWLEDGE_FOR_WIKIPEDIA_PEOPLE	SUBJECT_NAME:于禹	ATTRIBUTE:出生日期
请搜寻普耶的生日	KNOWLEDGE_FOR_WIKIPEDIA_PEOPLE	SUBJECT_NAME:普耶	ATTRIBUTE:生日
查莫里茨的家乡	KNOWLEDGE_FOR_WIKIPEDIA_PEOPLE	SUBJECT_NAME:莫里茨	ATTRIBUTE:家乡
给我查找列卡度哥斯达的身高	KNOWLEDGE_FOR_WIKIPEDIA_PEOPLE	SUBJECT_NAME:列卡度哥斯达	ATTRIBUTE:身高
给我查找哥斯尼的体重	KNOWLEDGE_FOR_WIKIPEDIA_PEOPLE	SUBJECT_NAME:哥斯尼	ATTRIBUTE:体重
德隆威廉姆斯个人历史	KNOWLEDGE_FOR_WIKIPEDIA_PEOPLE	SUBJECT_NAME:德隆威廉姆斯
安德烈曼托瓦尼个人资料里有什么	KNOWLEDGE_FOR_WIKIPEDIA_PEOPLE	SUBJECT_NAME:安德烈曼托瓦尼
奈特阿奇博尔德是个什么人	KNOWLEDGE_FOR_WIKIPEDIA_PEOPLE	SUBJECT_NAME:奈特阿奇博尔德
多米尼克威尔金斯是什么时候生的	KNOWLEDGE_FOR_WIKIPEDIA_PEOPLE	SUBJECT_NAME:多米尼克威尔金斯
伊登夏萨特的祖籍是哪儿的	KNOWLEDGE_FOR_WIKIPEDIA_PEOPLE	SUBJECT_NAME:伊登夏萨特	ATTRIBUTE:祖籍
亚历山德罗马特里体重多少斤	KNOWLEDGE_FOR_WIKIPEDIA_PEOPLE	SUBJECT_NAME:亚历山德罗马特里	ATTRIBUTE:体重
乔约翰逊的家乡在什么地方	KNOWLEDGE_FOR_WIKIPEDIA_PEOPLE	SUBJECT_NAME:乔约翰逊	ATTRIBUTE:家乡
搜一下裘斯的体重	KNOWLEDGE_FOR_WIKIPEDIA_PEOPLE	SUBJECT_NAME:裘斯	ATTRIBUTE:体重
跟我说赵余的生日是哪天	KNOWLEDGE_FOR_WIKIPEDIA_PEOPLE	SUBJECT_NAME:赵余	ATTRIBUTE:生日
请你帮我查一下海因索恩	KNOWLEDGE_FOR_WIKIPEDIA_PEOPLE	SUBJECT_NAME:海因索恩
请为我查看蒋哲的体重	KNOWLEDGE_FOR_WIKIPEDIA_PEOPLE	SUBJECT_NAME:蒋哲	ATTRIBUTE:体重
丁东浩到底多高	KNOWLEDGE_FOR_WIKIPEDIA_PEOPLE	SUBJECT_NAME:丁东浩	ATTRIBUTE:高
丁东浩到底有多胖	KNOWLEDGE_FOR_WIKIPEDIA_PEOPLE	SUBJECT_NAME:丁东浩	ATTRIBUTE:胖
格瑞斯贝尔是不是个英国人	KNOWLEDGE_FOR_WIKIPEDIA_PEOPLE	SUBJECT_NAME:格瑞斯贝尔
谁是李天风	KNOWLEDGE_FOR_WIKIPEDIA_PEOPLE	SUBJECT_NAME:李天风
谁是刘成风	KNOWLEDGE_FOR_WIKIPEDIA_PEOPLE	SUBJECT_NAME:刘成风
谁是胡长风	KNOWLEDGE_FOR_WIKIPEDIA_PEOPLE	SUBJECT_NAME:胡长风
张清风是谁？	KNOWLEDGE_FOR_WIKIPEDIA_PEOPLE	SUBJECT_NAME:张清风
谁是张天雨	KNOWLEDGE_FOR_WIKIPEDIA_PEOPLE	SUBJECT_NAME:张天雨
谁是王雨晴	KNOWLEDGE_FOR_WIKIPEDIA_PEOPLE	SUBJECT_NAME:王雨晴
谁是张玉雪	KNOWLEDGE_FOR_WIKIPEDIA_PEOPLE	SUBJECT_NAME:张玉雪
谁是陈雨清呢	KNOWLEDGE_FOR_WIKIPEDIA_PEOPLE	SUBJECT_NAME:陈雨清
张雨田是谁	KNOWLEDGE_FOR_WIKIPEDIA_PEOPLE	SUBJECT_NAME:张雨田
谁是张雄风	KNOWLEDGE_FOR_WIKIPEDIA_PEOPLE	SUBJECT_NAME:张雄风
李天一是谁	KNOWLEDGE_FOR_WIKIPEDIA_PEOPLE	SUBJECT_NAME:李天一
王日二是谁	KNOWLEDGE_FOR_WIKIPEDIA_PEOPLE	SUBJECT_NAME:王日二
刘丽君是谁的妻子	KNOWLEDGE_FOR_WIKIPEDIA_PEOPLE	SUBJECT_NAME:刘丽君	ATTRIBUTE:妻子
叶正是谁的丈夫	KNOWLEDGE_FOR_WIKIPEDIA_PEOPLE	SUBJECT_NAME:叶正
词语大会节目的主持人是谁	KNOWLEDGE_FOR_WIKIPEDIA_PEOPLE	ATTRIBUTE:词语大会节目的主持人
难忘今宵的作者是谁	KNOWLEDGE_FOR_WIKIPEDIA_PEOPLE	ATTRIBUTE:难忘今宵的作者
鞠躬尽瘁死而后以是写的谁	KNOWLEDGE_FOR_WIKIPEDIA_PEOPLE	ATTRIBUTE:鞠躬尽瘁死而后以
谁创作的背影这篇文章	KNOWLEDGE_FOR_WIKIPEDIA_PEOPLE	ATTRIBUTE:背影
谁是最可爱的人	KNOWLEDGE_FOR_WIKIPEDIA_PEOPLE	ATTRIBUTE:最可爱的人
公司的CEO是谁	KNOWLEDGE_FOR_WIKIPEDIA_PEOPLE	ATTRIBUTE:公司的CEO
我想了解习近平这个人	KNOWLEDGE_FOR_WIKIPEDIA_PEOPLE	ATTRIBUTE:习近平
