北京西城区的邮编是多少	KNOWLEDGE_POSTCODE	CITY:北京	DISTRICT:西城
查一下湖北黄石的邮编是多少	KNOWLEDGE_POSTCODE	PROVINCE:湖北	CITY:黄石
请帮忙搜索一下三亚河东区的邮政编码吧	KNOWLEDGE_POSTCODE	CITY:三亚	DISTRICT:河东
找下天津和平区的邮政编码是多少	KNOWLEDGE_POSTCODE	CITY:天津	DISTRICT:和平
给我查下桂林市七星区的邮编吧	KNOWLEDGE_POSTCODE	CITY:桂林	DISTRICT:七星
查下孝感市孝南区的邮编吧	KNOWLEDGE_POSTCODE	CITY:孝感	DISTRICT:孝南
吉林长春的邮编是多少啊	KNOWLEDGE_POSTCODE	PROVINCE:吉林	CITY:长春
查一下辽宁铁岭的邮编是多少啊	KNOWLEDGE_POSTCODE	PROVINCE:辽宁	CITY:铁岭
查下石家庄长安区的邮编是多少啊	KNOWLEDGE_POSTCODE	CITY:石家庄	DISTRICT:长安
找下新乡市新乡县的邮政编码是多少啊	KNOWLEDGE_POSTCODE	CITY:新乡	DISTRICT:新乡
给我找下山西小店区的邮政编码	KNOWLEDGE_POSTCODE	CITY:山西	DISTRICT:小店
查下鹤岗东山的邮政编码	KNOWLEDGE_POSTCODE	CITY:鹤岗	DISTRICT:东山
我要查下济南长青区的邮编	KNOWLEDGE_POSTCODE	CITY:济南	DISTRICT:长青
帮我找下苏州姑苏区的邮编	KNOWLEDGE_POSTCODE	CITY:苏州	DISTRICT:姑苏
我想看下合肥辖长峰县的邮编	KNOWLEDGE_POSTCODE	CITY:合肥	DISTRICT:辖长峰
帮我找下西宁格尔木的邮编吧	KNOWLEDGE_POSTCODE	CITY:西宁	DISTRICT:格尔木
帮我查下嘉兴市南湖区的邮编吧	KNOWLEDGE_POSTCODE	CITY:嘉兴	DISTRICT:南湖
帮我找下南昌市西湖区的邮编吧	KNOWLEDGE_POSTCODE	CITY:南昌	DISTRICT:西湖
我想查下上饶市信州区的邮编	KNOWLEDGE_POSTCODE	CITY:上饶	DISTRICT:信州
我想搜索下吉林四平的邮编	KNOWLEDGE_POSTCODE	PROVINCE:吉林	CITY:四平
我要看下福建福州的邮编	KNOWLEDGE_POSTCODE	PROVINCE:福建	CITY:福州
我要找下广州越秀区的邮编	KNOWLEDGE_POSTCODE	CITY:广州	DISTRICT:越秀
我要查找下广西南宁的邮编	KNOWLEDGE_POSTCODE	PROVINCE:广西	CITY:南宁
我要搜索下广西崇左的邮编	KNOWLEDGE_POSTCODE	PROVINCE:广西	CITY:崇左
我要查寻下云南大理的邮编	KNOWLEDGE_POSTCODE	PROVINCE:云南	CITY:大理
帮我查询下贵州贵阳的邮编	KNOWLEDGE_POSTCODE	PROVINCE:贵州	CITY:贵阳
我想查询下陕西西安的邮编	KNOWLEDGE_POSTCODE	PROVINCE:陕西	CITY:西安
帮我查询下黑河市孙吴县的邮编吧	KNOWLEDGE_POSTCODE	CITY:黑河	DISTRICT:孙吴
我要查寻金昌市永昌县的邮编	KNOWLEDGE_POSTCODE	CITY:金昌	DISTRICT:永昌
帮我查询青海西宁的邮编	KNOWLEDGE_POSTCODE	PROVINCE:青海	CITY:西宁
我想查询海南海口的邮编	KNOWLEDGE_POSTCODE	PROVINCE:海南	CITY:海口
帮我查询新北板桥区的邮编吧	KNOWLEDGE_POSTCODE	CITY:新北	DISTRICT:板桥
帮忙查询下香港九龙的邮编吧	KNOWLEDGE_POSTCODE	CITY:香港	DISTRICT:九龙
我想要查寻大庆萨尔图区的邮编	KNOWLEDGE_POSTCODE	CITY:大庆	DISTRICT:萨尔图
帮忙查询佳木斯前进区的邮编	KNOWLEDGE_POSTCODE	CITY:佳木斯	DISTRICT:前进
我想查询大连中山区的邮编	KNOWLEDGE_POSTCODE	CITY:大连	DISTRICT:中山
帮忙查询下葫芦岛连山的邮编吧	KNOWLEDGE_POSTCODE	CITY:葫芦岛	DISTRICT:连山
帮我看一下沈阳铁西区的邮编	KNOWLEDGE_POSTCODE	CITY:沈阳	DISTRICT:铁西
帮我看一下鞍山市立山区的邮编编码	KNOWLEDGE_POSTCODE	CITY:鞍山	DISTRICT:立山
帮我看一下抚顺望花区的邮编编码吧	KNOWLEDGE_POSTCODE	CITY:抚顺	DISTRICT:望花
能帮我看一下本溪桓仁满族自治县的邮编吗	KNOWLEDGE_POSTCODE	CITY:本溪	DISTRICT:桓仁满族自治县
请帮我看一下丹东宽甸县的邮编	KNOWLEDGE_POSTCODE	CITY:丹东	DISTRICT:宽甸
我需要辽阳文圣区的邮政编码	KNOWLEDGE_POSTCODE	CITY:辽阳	DISTRICT:文圣
帮我看一下铁岭天德的邮政编码	KNOWLEDGE_POSTCODE	CITY:铁岭	DISTRICT:天德
帮我看一下朝阳顺义区的邮编	KNOWLEDGE_POSTCODE	CITY:朝阳	DISTRICT:顺义
帮我看一下盘锦兴隆台区的邮编吧	KNOWLEDGE_POSTCODE	CITY:盘锦	DISTRICT:兴隆台
能帮我看一下锦州沟帮子的邮政编码吗	KNOWLEDGE_POSTCODE	CITY:锦州	DISTRICT:沟帮子
请帮我看一下阜新细河区的邮政编码	KNOWLEDGE_POSTCODE	CITY:阜新	DISTRICT:细河
我需要长春宽城的邮编	KNOWLEDGE_POSTCODE	CITY:长春	DISTRICT:宽城
搜索下四平梨树县的邮编	KNOWLEDGE_POSTCODE	CITY:四平	DISTRICT:梨树
搜索下通化东昌的邮编吧	KNOWLEDGE_POSTCODE	CITY:通化	DISTRICT:东昌
搜索一下白山八道江的邮编	KNOWLEDGE_POSTCODE	CITY:白山	DISTRICT:八道江
搜索一下辽源龙山的邮编吧	KNOWLEDGE_POSTCODE	CITY:辽源	DISTRICT:龙山
搜索下白城洮北的邮政编码	KNOWLEDGE_POSTCODE	CITY:白城	DISTRICT:洮北
搜索下松原长岭县的邮政编码吧	KNOWLEDGE_POSTCODE	CITY:松原	DISTRICT:长岭
帮我查找成都青羊区的邮政编码	KNOWLEDGE_POSTCODE	CITY:成都	DISTRICT:青羊
帮我查找一下四川丹棱县的邮政编码	KNOWLEDGE_POSTCODE	PROVINCE:四川	CITY:丹棱
帮我查找襄阳宜城的邮编	KNOWLEDGE_POSTCODE	CITY:襄阳	DISTRICT:宜城
帮我查找眉山彭山区的邮编吧	KNOWLEDGE_POSTCODE	CITY:眉山	DISTRICT:彭山
给我南充顺庆邮编	KNOWLEDGE_POSTCODE	CITY:南充	DISTRICT:顺庆
给我泸州龙马潭邮政编码	KNOWLEDGE_POSTCODE	CITY:泸州	DISTRICT:龙马潭
给我一下德阳三水邮编	KNOWLEDGE_POSTCODE	CITY:德阳	DISTRICT:三水
给我一下广元利州区邮政编码	KNOWLEDGE_POSTCODE	CITY:广元	DISTRICT:利州
荆州市公安县邮编是	KNOWLEDGE_POSTCODE	CITY:荆州	DISTRICT:公安
郑州郑东新区邮政编码是	KNOWLEDGE_POSTCODE	CITY:郑州	DISTRICT:郑东新
安阳文峰区的邮编是啥	KNOWLEDGE_POSTCODE	CITY:安阳	DISTRICT:文峰
嘉兴海盐的邮编是多少	KNOWLEDGE_POSTCODE	CITY:嘉兴	DISTRICT:海盐
苏州姑苏区的邮政编码是啥	KNOWLEDGE_POSTCODE	CITY:苏州	DISTRICT:姑苏
杭州滨江区的邮政编码是多少	KNOWLEDGE_POSTCODE	CITY:杭州	DISTRICT:滨江
看下雅安汉源县的邮政编码是多少	KNOWLEDGE_POSTCODE	CITY:雅安	DISTRICT:汉源
看一下石家庄桥东区的邮政编码是多少	KNOWLEDGE_POSTCODE	CITY:石家庄	DISTRICT:桥东
看下唐山迁西县的邮政编码是	KNOWLEDGE_POSTCODE	CITY:唐山	DISTRICT:迁西
看下邯郸鸡泽县的邮政编码是多少啊	KNOWLEDGE_POSTCODE	CITY:邯郸	DISTRICT:鸡泽
看一下秦皇岛北戴河的邮政编码是	KNOWLEDGE_POSTCODE	CITY:秦皇岛	DISTRICT:北戴河
看一下陵水屯昌县的邮政编码是多少啊	KNOWLEDGE_POSTCODE	CITY:陵水	DISTRICT:屯昌
给我看一下昌江黎族自治县的邮政编码	KNOWLEDGE_POSTCODE	CITY:昌江	DISTRICT:黎族自治
给我看一下许昌许昌县的邮政编码是	KNOWLEDGE_POSTCODE	CITY:许昌	DISTRICT:许昌
看下重庆白沙的邮编是多少	KNOWLEDGE_POSTCODE	CITY:重庆	DISTRICT:白沙
看一下吉林石岭子的邮编是多少	KNOWLEDGE_POSTCODE	CITY:吉林	CITY:石岭子
看下南京玄武的邮编是	KNOWLEDGE_POSTCODE	CITY:南京	DISTRICT:玄武
看下南京六合的邮编是多少啊	KNOWLEDGE_POSTCODE	CITY:南京	DISTRICT:六合
看一下辽宁开原的邮编是	KNOWLEDGE_POSTCODE	PROVINCE:辽宁	CITY:开原
看一下高昌的邮编是多少啊	KNOWLEDGE_POSTCODE	CITY:高昌
给我看一下恩施的邮编	KNOWLEDGE_POSTCODE	CITY:恩施
给我看一下西双版纳的邮编是	KNOWLEDGE_POSTCODE	CITY:西双版纳
我需要看一下新疆的邮政编码	KNOWLEDGE_POSTCODE	PROVINCE:新疆
我需要看一下长春的邮编	KNOWLEDGE_POSTCODE	CITY:长春
帮忙看下怒江的邮编	KNOWLEDGE_POSTCODE	CITY:怒江
帮忙查找下芜湖的邮编	KNOWLEDGE_POSTCODE	CITY:芜湖
帮忙搜索下大同的邮编	KNOWLEDGE_POSTCODE	CITY:大同
请帮忙搜索下太谷的邮编	KNOWLEDGE_POSTCODE	CITY:太谷
请帮忙搜索一下黔江的邮编	KNOWLEDGE_POSTCODE	CITY:黔江
请帮忙搜索下长治的邮编吧	KNOWLEDGE_POSTCODE	CITY:长治
请帮忙搜索一下阳泉的邮编吧	KNOWLEDGE_POSTCODE	CITY:阳泉
我需要看一下淄博的邮政编码	KNOWLEDGE_POSTCODE	CITY:淄博
帮忙看下威海的邮政编码	KNOWLEDGE_POSTCODE	CITY:威海
帮忙查找下渤海的邮政编码	KNOWLEDGE_POSTCODE	CITY:渤海
帮忙搜索下菏泽的邮政编码	KNOWLEDGE_POSTCODE	CITY:菏泽
请帮忙搜索下天德的邮政编码	KNOWLEDGE_POSTCODE	CITY:天德
请帮忙搜索一下随州的邮政编码	KNOWLEDGE_POSTCODE	CITY:随州
请帮忙搜索下潜江的邮政编码吧	KNOWLEDGE_POSTCODE	CITY:潜江
邮编 扬州的	KNOWLEDGE_POSTCODE	CITY:扬州
邮编 天津市的	KNOWLEDGE_POSTCODE	CITY:天津
邮政编码 三槐的	KNOWLEDGE_POSTCODE	CITY:三槐
邮编编码 晋江市的	KNOWLEDGE_POSTCODE	CITY:晋江
查下黄冈的邮编是多少	KNOWLEDGE_POSTCODE	CITY:黄冈
武汉市洪山区的邮编	KNOWLEDGE_POSTCODE	CITY:武汉	DISTRICT:洪山
查下孝感市安陆市的邮编	KNOWLEDGE_POSTCODE	CITY:孝感	DISTRICT:安陆
黄冈麻城市的邮编	KNOWLEDGE_POSTCODE	CITY:黄冈	DISTRICT:麻城
深圳宝安区的邮编	KNOWLEDGE_POSTCODE	CITY:深圳	DISTRICT:宝安
广州市番禺区的邮编	KNOWLEDGE_POSTCODE	CITY:广州	DISTRICT:番禺
重庆市万州区的邮编是多少	KNOWLEDGE_POSTCODE	CITY:重庆	DISTRICT:万州
桂林叠彩区的邮编	KNOWLEDGE_POSTCODE	CITY:桂林	DISTRICT:叠彩
广州番禺区的邮编	KNOWLEDGE_POSTCODE	CITY:广州	DISTRICT:番禺
湘潭市的邮编是多少	KNOWLEDGE_POSTCODE	CITY:湘潭
钦州市的邮编是多少	KNOWLEDGE_POSTCODE	CITY:钦州
洛阳的邮编是多少呢	KNOWLEDGE_POSTCODE	CITY:洛阳
常德市的邮编是多少呢	KNOWLEDGE_POSTCODE	CITY:常德
十堰市的邮编是多少	KNOWLEDGE_POSTCODE	CITY:十堰
河池市的邮编是什么	KNOWLEDGE_POSTCODE	CITY:河池
开封的邮编是什么呢	KNOWLEDGE_POSTCODE	CITY:开封
许昌市的邮编是什么呢	KNOWLEDGE_POSTCODE	CITY:许昌
武汉江夏区的邮编是多少	KNOWLEDGE_POSTCODE	CITY:武汉	DISTRICT:江夏
告诉我武汉江夏区的邮编是多少	KNOWLEDGE_POSTCODE	CITY:武汉	DISTRICT:江夏
找一下武汉江夏区的邮编是多少	KNOWLEDGE_POSTCODE	CITY:武汉	DISTRICT:江夏
查下武汉江夏区的邮编是多少	KNOWLEDGE_POSTCODE	CITY:武汉	DISTRICT:江夏
查下武汉江夏区的邮编是多少呢	KNOWLEDGE_POSTCODE	CITY:武汉	DISTRICT:江夏
查下武汉江夏区的邮编是多少了	KNOWLEDGE_POSTCODE	CITY:武汉	DISTRICT:江夏
武汉新洲区的邮编是啥	KNOWLEDGE_POSTCODE	CITY:武汉	DISTRICT:新洲
武汉新洲区的邮编是啥呢	KNOWLEDGE_POSTCODE	CITY:武汉	DISTRICT:新洲
浙江省的邮编是啥呢	KNOWLEDGE_POSTCODE	PROVINCE:浙江
广东省的邮编	KNOWLEDGE_POSTCODE	PROVINCE:广东
陕西省西安市的邮编	KNOWLEDGE_POSTCODE	PROVINCE:陕西	CITY:西安
湖北省孝感市的邮编	KNOWLEDGE_POSTCODE	PROVINCE:湖北	CITY:孝感
天河区的邮编	KNOWLEDGE_POSTCODE	DISTRICT:天河
南山区的邮编	KNOWLEDGE_POSTCODE	DISTRICT:南山
黄陂区的邮编是多少	KNOWLEDGE_POSTCODE	DISTRICT:黄陂
青山区的邮编是多少	KNOWLEDGE_POSTCODE	DISTRICT:青山
福田区的邮编是多少	KNOWLEDGE_POSTCODE	DISTRICT:福田
花都区的邮编是多少	KNOWLEDGE_POSTCODE	DISTRICT:花都
武汉邮编多少	KNOWLEDGE_POSTCODE	CITY:武汉
广州邮编多少	KNOWLEDGE_POSTCODE	CITY:广州
天津邮编	KNOWLEDGE_POSTCODE	CITY:天津
桂林邮编	KNOWLEDGE_POSTCODE	CITY:桂林
孝感市邮编	KNOWLEDGE_POSTCODE	CITY:孝感
十堰市邮编	KNOWLEDGE_POSTCODE	CITY:十堰
北京市东城区的邮编	KNOWLEDGE_POSTCODE	CITY:北京	DISTRICT:东城
上海邮编	KNOWLEDGE_POSTCODE	CITY:上海
