08年奥运会开幕式都有谁唱歌	MUSIC_SEARCH	year:08年
11月的肖邦这个专辑里的歌都是谁写的	MUSIC_SEARCH	ALBUMNAME:11月的肖邦
11月的肖邦里面有什么英文歌曲	MUSIC_SEARCH	GENRE:英文歌曲	ALBUMNAME:11月的肖邦
11月的肖邦里面都是什么年份的歌曲	MUSIC_SEARCH	ALBUMNAME:11月的肖邦
12新作这张专辑是几十年代出的	MUSIC_SEARCH	ALBUMNAME:12新作
MJ曾经演唱过多少首歌曲	MUSIC_SEARCH	ARTIST_OR_COMPOSER:MJ
一万个对不起 这个专辑是谁做的	MUSIC_SEARCH	ALBUMNAME:一万个对不起
一个人的屋顶是作做的词	MUSIC_SEARCH	TITLE:一个人的屋顶
一个人走的曲子是抄的哪首歌	MUSIC_SEARCH	TITLE:一个人走
一个旅人这首歌属于什么曲风	MUSIC_SEARCH	TITLE:一个旅人
一开始就知道是哪里的歌曲	MUSIC_SEARCH	TITLE:一开始就知道
一念之间这张专辑是谁出的	MUSIC_SEARCH	ALBUMNAME:一念之间
一念之间这张专辑由哪个公司发行的	MUSIC_SEARCH	ALBUMNAME:一念之间
一片痴这首歌非常得流行么	MUSIC_SEARCH	TITLE:一片痴
一路向北这首歌是谁唱的	MUSIC_SEARCH	TITLE:一路向北
一首心歌去年的发行量是多少	MUSIC_SEARCH	year:去年	ALBUMNAME:一首心歌
一首心歌的歌曲风格是什么	MUSIC_SEARCH	ALBUMNAME:一首心歌
一首心歌这张专辑是什么时候发行的	MUSIC_SEARCH	ALBUMNAME:一首心歌
一首心歌里面有几首歌	MUSIC_SEARCH	ALBUMNAME:一首心歌
丁丁唱过的歌搜索一下	MUSIC_SEARCH	ARTIST_OR_COMPOSER:丁丁
丁丁这个歌手有什么专辑	MUSIC_SEARCH	ARTIST_OR_COMPOSER:丁丁
丁香晓晓唱过的有谁能够爱你超过我	MUSIC_SEARCH	ARTIST_OR_COMPOSER:丁香晓晓	TITLE:有谁能够爱你超过我
七号公园这首歌的评论怎么样	MUSIC_SEARCH	TITLE:七号公园
七月初七的作曲家叫什么名字	MUSIC_SEARCH	TITLE:七月初七
七步诗这首歌怎么样	MUSIC_SEARCH	TITLE:七步诗
七里香的歌曲内容都是什么	MUSIC_SEARCH	ALBUMNAME:七里香
七里香这个专辑属于谁	MUSIC_SEARCH	ALBUMNAME:七里香
七里香这个音乐专辑很流行么	MUSIC_SEARCH	ALBUMNAME:七里香
七里香里面有什么英文歌曲	MUSIC_SEARCH	GENRE:英文歌曲	ALBUMNAME:七里香
七里香里面的歌曲都有什么音乐元素	MUSIC_SEARCH	ALBUMNAME:七里香
万众瞩目的歌词都说的什么	MUSIC_SEARCH	TITLE:万众瞩目
万有引力这个专辑怎么样	MUSIC_SEARCH	ALBUMNAME:万有引力
万物生在哪个专辑里	MUSIC_SEARCH	TITLE:万物生
三天三夜这个专辑出自哪个歌手	MUSIC_SEARCH	ALBUMNAME:三天三夜
三月小雨多长	MUSIC_SEARCH	TITLE:三月小雨
三浦大知的那首同船过渡	MUSIC_SEARCH	ARTIST_OR_COMPOSER:三浦大知	TITLE:同船过渡
上一个歌叫什么名字	MUSIC_PLAY	ANAPHOR:上一个歌
上一首歌叫什么来着	MUSIC_PLAY	ANAPHOR:上一首歌
上不完的课唱的是谁的故事	MUSIC_SEARCH	TITLE:上不完的课
上个歌曲的歌曲信息	MUSIC_PLAY	ANAPHOR:上个歌曲
上帝创造女人这首歌有多长	MUSIC_SEARCH	TITLE:上帝创造女人
上海滩这首歌是哪个歌手的	MUSIC_SEARCH	TITLE:上海滩
上网找找不敢太爱你这首歌	MUSIC_SEARCH	TITLE:不敢太爱你
上网找找中国人民解放军军歌这首歌	MUSIC_SEARCH	TITLE:中国人民解放军军歌
上网找找哀怜这首歌	MUSIC_SEARCH	TITLE:哀怜
上网找找小小快乐这首歌	MUSIC_SEARCH	TITLE:小小快乐
上网搜索革命歌曲	MUSIC_SEARCH	GENRE:革命歌曲
上网查找12新作的发行的时间	MUSIC_SEARCH	ALBUMNAME:12新作
上网查找京剧	MUSIC_SEARCH	GENRE:京剧
上网查找十一月的肖邦的发行的时间	MUSIC_SEARCH	ALBUMNAME:十一月的肖邦
上网查找捍卫阳光的发行的时间	MUSIC_SEARCH	ALBUMNAME:捍卫阳光
上网查找纯属意外的发行的时间	MUSIC_SEARCH	ALBUMNAME:纯属意外
上首歌叫什么名字	MUSIC_PLAY	ANAPHOR:上首歌
上首歌曲的歌词是什么	MUSIC_PLAY	ANAPHOR:上首歌曲
下一个歌叫啥	MUSIC_PLAY	ANAPHOR:下一个歌
下一首歌是什么	MUSIC_PLAY	ANAPHOR:下一首歌
下下首歌是什么	MUSIC_PLAY	ANAPHOR:下下首歌
下个歌曲的名称是什么	MUSIC_PLAY	ANAPHOR:下个歌曲
下载一些小提琴曲	MUSIC_SEARCH	GENRE:小提琴曲
下载专辑放心不下里的所有乐曲	MUSIC_SEARCH	ALBUMNAME:放心不下
下载专辑暂存里的所有乐曲	MUSIC_SEARCH	ALBUMNAME:暂存
下载专辑第一次里的所有乐曲	MUSIC_SEARCH	ALBUMNAME:第一次
下载专辑陪我去流浪里的所有乐曲	MUSIC_SEARCH	ALBUMNAME:陪我去流浪
下辈子不做男人是哪年首唱的	MUSIC_SEARCH	TITLE:下辈子不做男人
下首歌曲叫什么	MUSIC_PLAY	ANAPHOR:下首歌曲
不会分离是几几年发行的	MUSIC_SEARCH	ALBUMNAME:不会分离
不会分离是周杰伦的专辑么	MUSIC_SEARCH	ARTIST_OR_COMPOSER:周杰伦	ALBUMNAME:不会分离
不会分离里面有哪个年代的歌曲	MUSIC_SEARCH	ALBUMNAME:不会分离
不会有谁能让我后悔都有什么语言的版本	MUSIC_SEARCH	TITLE:不会有谁能让我后悔
不可以逃避这首歌是哪个歌手的	MUSIC_SEARCH	TITLE:不可以逃避
不容错失的歌名啥意思	MUSIC_SEARCH	TITLE:不容错失
不流泪的机场这首歌的音乐好听么	MUSIC_SEARCH	TITLE:不流泪的机场
不装饰你的梦是谁唱的	MUSIC_SEARCH	TITLE:不装饰你的梦
不要让她再受伤属于什么歌	MUSIC_SEARCH	TITLE:不要让她再受伤
不说分手属于什么类型的歌曲	MUSIC_SEARCH	TITLE:不说分手
专辑一万次再见如何	MUSIC_SEARCH	ALBUMNAME:一万次再见
专辑一条命如何	MUSIC_SEARCH	ALBUMNAME:一条命
专辑以爱之名的发行日期是什么	MUSIC_SEARCH	ALBUMNAME:以爱之名
专辑全面回忆 如何	MUSIC_SEARCH	ALBUMNAME:全面回忆
专辑因为爱着你如何	MUSIC_SEARCH	ALBUMNAME:因为爱着你
专辑复克如何	MUSIC_SEARCH	ALBUMNAME:复克
专辑完美女人如何	MUSIC_SEARCH	ALBUMNAME:完美女人
专辑我忘了 如何	MUSIC_SEARCH	ALBUMNAME:我忘了
专辑排行在什么年代发行的	MUSIC_SEARCH	ALBUMNAME:专辑排行
专辑排行里面的歌曲的曲风是什么	MUSIC_SEARCH	ALBUMNAME:专辑排行
专辑最好的时光如何	MUSIC_SEARCH	ALBUMNAME:最好的时光
专辑梦缠绵如何	MUSIC_SEARCH	ALBUMNAME:梦缠绵
专辑歌未央如何	MUSIC_SEARCH	ALBUMNAME:歌未央
专辑永远的永远的发行日期是什么	MUSIC_SEARCH	ALBUMNAME:永远的永远
专辑爱的进行式的制作公司叫什么名字	MUSIC_SEARCH	ALBUMNAME:爱的进行式
专辑爵式好情歌如何	MUSIC_SEARCH	ALBUMNAME:爵式好情歌
专辑盛开的发行日期是什么	MUSIC_SEARCH	ALBUMNAME:盛开
专辑看海的制作公司叫什么名字	MUSIC_SEARCH	ALBUMNAME:看海
专辑看走眼如何	MUSIC_SEARCH	ALBUMNAME:看走眼
专辑等等的制作公司叫什么名字	MUSIC_SEARCH	ALBUMNAME:等等
专辑致敬经典如何	MUSIC_SEARCH	ALBUMNAME:致敬经典
专辑还好遇见你如何	MUSIC_SEARCH	ALBUMNAME:还好遇见你
专辑陪我去流浪的发行日期是什么	MUSIC_SEARCH	ALBUMNAME:陪我去流浪
专辑青春再见的制作公司叫什么名字	MUSIC_SEARCH	ALBUMNAME:青春再见
专辑风从哪里来如何	MUSIC_SEARCH	ALBUMNAME:风从哪里来
世界上有没有真爱是不是在六十年代很流行	MUSIC_SEARCH	TITLE:世界上有没有真爱	year:六十年代
丛尸系冥河是哪个电影里的歌曲么	MUSIC_SEARCH	TITLE:丛尸系冥河
东山少爷新专辑	MUSIC_SEARCH	ARTIST_OR_COMPOSER:东山少爷
丢失了梦的清晨是什么专辑里的歌	MUSIC_SEARCH	TITLE:丢失了梦的清晨
两个人的月亮是什么样的歌曲	MUSIC_SEARCH	TITLE:两个人的月亮
两位一体是哪个专辑里的歌	MUSIC_SEARCH	TITLE:两位一体
中国女孩现在还流行吗	MUSIC_SEARCH	TITLE:中国女孩
丹吉布森唱过的完美冬天	MUSIC_SEARCH	ARTIST_OR_COMPOSER:丹吉布森	TITLE:完美冬天
为何他会离开你属于几十年代的歌曲	MUSIC_SEARCH	TITLE:为何他会离开你
为何女人是流水的河的曲风是什么	MUSIC_SEARCH	TITLE:为何女人是流水的河
为所有爱我们的人这首歌是乡村音乐么	MUSIC_SEARCH	GENRE:乡村音乐	TITLE:为所有爱我们的人
主角爱你的词是哪首宋词	MUSIC_SEARCH	TITLE:主角爱你
九号球是不是一个电影歌曲	MUSIC_SEARCH	GENRE:电影歌曲	TITLE:九号球
乡恋的作词家是什么	MUSIC_SEARCH	TITLE:乡恋
了不起这首歌流行么	MUSIC_SEARCH	TITLE:了不起
二缺一这首歌非常得流行么	MUSIC_SEARCH	TITLE:二缺一
五分熟是不是个流行音乐	MUSIC_SEARCH	GENRE:流行音乐	TITLE:五分熟
亚明唱过的深爱	MUSIC_SEARCH	ARTIST_OR_COMPOSER:亚明	TITLE:深爱
亚瑞纳专辑的信息	MUSIC_SEARCH	ARTIST_OR_COMPOSER:亚瑞纳
亚瑟小子歌组	MUSIC_SEARCH	ARTIST_OR_COMPOSER:亚瑟小子
亲爱的对不起这首歌在什么专辑	MUSIC_SEARCH	TITLE:亲爱的对不起
亲爱的祖国的什么地区的歌	MUSIC_SEARCH	TITLE:亲爱的祖国
亲爱的路人这张专辑下面有什么曲目	MUSIC_SEARCH	ALBUMNAME:亲爱的路人
亲爱的路人这张专辑是什么时候发行的	MUSIC_SEARCH	ALBUMNAME:亲爱的路人
亲爱的路人这首专辑是哪天发行	MUSIC_SEARCH	ALBUMNAME:亲爱的路人
亲爱的路人里的歌曲主要是谁写的曲	MUSIC_SEARCH	ALBUMNAME:亲爱的路人
亲爱的路人里面的歌曲都有什么	MUSIC_SEARCH	ALBUMNAME:亲爱的路人
人生无悔这首歌怎么样	MUSIC_SEARCH	TITLE:人生无悔
人生百年的作曲家叫什么名字	MUSIC_SEARCH	TITLE:人生百年
人生第一次是不是八十年代的经典老歌	MUSIC_SEARCH	year:八十年代	GENRE:经典老歌	TITLE:人生第一次
人生第一次这首歌怎么样	MUSIC_SEARCH	TITLE:人生第一次
人鱼算不算是比较非主流的音乐	MUSIC_SEARCH	GENRE:非主流	TITLE:人鱼
亿万克拉的幸福唱的是谁的故事	MUSIC_SEARCH	TITLE:亿万克拉的幸福
什么是丁香姑娘的分类	MUSIC_SEARCH	TITLE:丁香姑娘
什么是为了爱的分类	MUSIC_SEARCH	TITLE:为了爱
什么是圣诞节音乐	MUSIC_SEARCH	GENRE:圣诞节音乐
什么是幸福离我们很近的分类	MUSIC_SEARCH	TITLE:幸福离我们很近
什么是我想有个家的分类	MUSIC_SEARCH	TITLE:我想有个家
什么英文歌和故事未完成的曲调一样	MUSIC_SEARCH	TITLE:故事未完成
什么英文歌和曾经的你的曲调一样	MUSIC_SEARCH	TITLE:曾经的你
什么英文歌和淡淡忧郁的曲调一样	MUSIC_SEARCH	TITLE:淡淡忧郁
什么英文歌和风中的承诺的曲调一样	MUSIC_SEARCH	TITLE:风中的承诺
今年新出了什么歌	MUSIC_SEARCH	year:今年
今年格莱美奖各奖歌手都有哪些	MUSIC_SEARCH	year:今年
今年格莱美奖各奖歌手都有谁	MUSIC_SEARCH	year:今年
今生共明月是不是周杰伦唱过的	MUSIC_SEARCH	ARTIST_OR_COMPOSER:周杰伦	TITLE:今生共明月
介绍一下唱下辈子如果我还记得你的歌手	MUSIC_SEARCH	TITLE:下辈子如果我还记得你
介绍一下唱千秋家园梦的歌手	MUSIC_SEARCH	TITLE:千秋家园梦
介绍一下唱宝贝都是我的错的歌手	MUSIC_SEARCH	TITLE:宝贝都是我的错
介绍一下唱认真的歌手	MUSIC_SEARCH	TITLE:认真
从军歌的歌词都说的什么	MUSIC_SEARCH	TITLE:从军歌
从头再来这首歌怎么样	MUSIC_SEARCH	TITLE:从头再来
从网上查找下载歌曲感激我遇见	MUSIC_SEARCH	TITLE:感激我遇见
从网上查找下载歌曲星愿	MUSIC_SEARCH	TITLE:星愿
从网上查找下载歌曲爱不懂事	MUSIC_SEARCH	TITLE:爱不懂事
从网上查找下载歌曲爱有灵犀	MUSIC_SEARCH	TITLE:爱有灵犀
他是什么时候的歌	MUSIC_SEARCH	TITLE:他
他离去的那天在哪个专辑里	MUSIC_SEARCH	TITLE:他离去的那天
仙尼亚唐恩的终极三国	MUSIC_SEARCH	ARTIST_OR_COMPOSER:仙尼亚唐恩	TITLE:终极三国
以爱之名是哪年发行的	MUSIC_SEARCH	ALBUMNAME:以爱之名
以爱之名里面是不是都是七十年代的歌	MUSIC_SEARCH	year:七十年代	ALBUMNAME:以爱之名
任贤齐的歌好听么	MUSIC_SEARCH	ARTIST_OR_COMPOSER:任贤齐
企图这个歌由谁演唱过	MUSIC_SEARCH	TITLE:企图
会飞的贼在哪天发行的	MUSIC_SEARCH	ALBUMNAME:会飞的贼
会飞的贼这张专辑是什么时候发行的	MUSIC_SEARCH	ALBUMNAME:会飞的贼
会飞的贼里面的曲风是什么	MUSIC_SEARCH	ALBUMNAME:会飞的贼
会飞的贼里面的歌有名么	MUSIC_SEARCH	ALBUMNAME:会飞的贼
传奇这首歌是从哪儿来的	MUSIC_SEARCH	TITLE:传奇
伤心的日子的作曲是谁	MUSIC_SEARCH	TITLE:伤心的日子
似是故人来这个专辑是谁做的	MUSIC_SEARCH	ALBUMNAME:似是故人来
低调的作词家是什么	MUSIC_SEARCH	TITLE:低调
何必再拖是什么时候发行的	MUSIC_SEARCH	ALBUMNAME:何必再拖
何必再拖这张专辑是什么时候出的	MUSIC_SEARCH	ALBUMNAME:何必再拖
何忻翰的偷心海盗	MUSIC_SEARCH	ARTIST_OR_COMPOSER:何忻翰	TITLE:偷心海盗
余力机构的那首淡水河边	MUSIC_SEARCH	ARTIST_OR_COMPOSER:余力机构	TITLE:淡水河边
作阵走这首歌有没有法语版	MUSIC_SEARCH	TITLE:作阵走
你会不会的歌词都说的什么	MUSIC_SEARCH	TITLE:你会不会
你怎么舍得我为你哭是哪年首唱的	MUSIC_SEARCH	TITLE:你怎么舍得我为你哭
你怎么舍得让我掉眼泪是谁作的曲	MUSIC_SEARCH	TITLE:你怎么舍得让我掉眼泪
你把你自己很好听么	MUSIC_SEARCH	TITLE:你把你自己
你把我的女人带走用在哪些电影里	MUSIC_SEARCH	TITLE:你把我的女人带走
你是我一生最爱的人这首歌几分钟长	MUSIC_SEARCH	TITLE:你是我一生最爱的人
你是我最爱的人来自于什么年代	MUSIC_SEARCH	TITLE:你是我最爱的人
你是我的靠山现在还流行吗	MUSIC_SEARCH	TITLE:你是我的靠山
你是这样的人这首歌怎么样	MUSIC_SEARCH	TITLE:你是这样的人
你来你走是作做的曲	MUSIC_SEARCH	TITLE:你来你走
你的唇我没吻过这首歌是什么时候演出的	MUSIC_SEARCH	TITLE:你的唇我没吻过
你离开了一年这首歌在什么分类里	MUSIC_SEARCH	TITLE:你离开了一年
你说得对有很多人听么	MUSIC_SEARCH	TITLE:你说得对
依然是朋友被谁演唱过	MUSIC_SEARCH	TITLE:依然是朋友
依然范特西这个专辑是谁写的	MUSIC_SEARCH	ALBUMNAME:依然范特西
依然范特西这张专辑由哪个公司发行的	MUSIC_SEARCH	ALBUMNAME:依然范特西
依然范特西里面全是什么类型的歌	MUSIC_SEARCH	ALBUMNAME:依然范特西
侠侣神雕的歌词	MUSIC_SEARCH	TITLE:侠侣神雕
侧脸这首歌谁演唱过	MUSIC_SEARCH	TITLE:侧脸
侯磊的歌曲好听么	MUSIC_SEARCH	ARTIST_OR_COMPOSER:侯磊
信天游这首歌来自哪个国家	MUSIC_SEARCH	TITLE:信天游
借口现在有多流行	MUSIC_SEARCH	TITLE:借口
假装幸福是不是比较好听	MUSIC_SEARCH	TITLE:假装幸福
做人难这首歌的风格是什么	MUSIC_SEARCH	TITLE:做人难
停留是哪个电视剧的片尾曲	MUSIC_SEARCH	TITLE:停留
健康歌这首歌什么时候发行的	MUSIC_SEARCH	TITLE:健康歌
催天琪的歌曲有哪些	MUSIC_SEARCH	ARTIST_OR_COMPOSER:催天琪
催天琪的歌曲都好听么	MUSIC_SEARCH	ARTIST_OR_COMPOSER:催天琪
催子格的歌是什么风格的	MUSIC_SEARCH	ARTIST_OR_COMPOSER:催子格
傻傻的爱自己的什么地区的歌	MUSIC_SEARCH	TITLE:傻傻的爱自己
元气这首歌的主题是什么	MUSIC_SEARCH	TITLE:元气
兄弟一条心这个专辑是谁做的	MUSIC_SEARCH	ALBUMNAME:兄弟一条心
兄弟的作词家是谁	MUSIC_SEARCH	TITLE:兄弟
光良唱了单身潜逃吗	MUSIC_SEARCH	ARTIST_OR_COMPOSER:光良	TITLE:单身潜逃
光芒属于什么类型的音乐	MUSIC_SEARCH	ALBUMNAME:光芒
光芒这张专辑里有哪几首歌	MUSIC_SEARCH	ALBUMNAME:光芒
光芒里面歌曲的风格是什么	MUSIC_SEARCH	ALBUMNAME:光芒
光芒里面的曲风是什么	MUSIC_SEARCH	ALBUMNAME:光芒
光里面有哪几首歌	MUSIC_SEARCH	ALBUMNAME:光
全场沸腾这首歌的主题是什么	MUSIC_SEARCH	TITLE:全场沸腾
八十年代流行什么类型的歌	MUSIC_SEARCH	year:八十年代
八度空间这个专辑出自哪个歌手	MUSIC_SEARCH	ALBUMNAME:八度空间
八度空间里都有哪些歌	MUSIC_SEARCH	ALBUMNAME:八度空间
公路的作曲家是谁	MUSIC_SEARCH	TITLE:公路
六十年代流行什么样的歌	MUSIC_SEARCH	year:六十年代
兰陵王的歌曲主要是由谁演唱的	MUSIC_SEARCH	ALBUMNAME:兰陵王
兰陵王里面的歌曲都是哪几个歌手唱的	MUSIC_SEARCH	ALBUMNAME:兰陵王
关不掉的月光这张专辑下面有什么曲目	MUSIC_SEARCH	ALBUMNAME:关不掉的月光
关不掉的月光里面的歌曲的曲风是什么	MUSIC_SEARCH	ALBUMNAME:关不掉的月光
关于爱这首歌的风格是什么	MUSIC_SEARCH	TITLE:关于爱
关心是哪里的歌曲	MUSIC_SEARCH	TITLE:关心
其实你可以是哪年首唱的	MUSIC_SEARCH	TITLE:其实你可以
其实我也不知道的歌词是什么	MUSIC_SEARCH	TITLE:其实我也不知道
具俊烨专辑的信息	MUSIC_SEARCH	ARTIST_OR_COMPOSER:具俊烨
再吻我吧这首歌有没有法语版	MUSIC_SEARCH	TITLE:再吻我吧
再爱一遍的歌曲主要是由谁演唱的	MUSIC_SEARCH	ALBUMNAME:再爱一遍
再爱一遍里面有哪个年代的歌曲	MUSIC_SEARCH	ALBUMNAME:再爱一遍
再等几天是谁演唱的	MUSIC_SEARCH	TITLE:再等几天
再见你好吗卖多少钱	MUSIC_SEARCH	ALBUMNAME:再见你好吗
再见你好吗发行当天的销量如何	MUSIC_SEARCH	ALBUMNAME:再见你好吗
再见你好吗是什么时候发行的	MUSIC_SEARCH	ALBUMNAME:再见你好吗
再见王子里面歌曲的名字都是什么	MUSIC_SEARCH	ALBUMNAME:再见王子
再见王子里面都是那个年代的歌	MUSIC_SEARCH	ALBUMNAME:再见王子
农夫系你老死被谁翻唱过	MUSIC_SEARCH	TITLE:农夫系你老死
冬天快乐是哪个年代创作的	MUSIC_SEARCH	TITLE:冬天快乐
冯玮君的闹情绪	MUSIC_SEARCH	ARTIST_OR_COMPOSER:冯玮君	TITLE:闹情绪
冯翠桦唱过的爱得起	MUSIC_SEARCH	ARTIST_OR_COMPOSER:冯翠桦	TITLE:爱得起
冲破封锁线是由谁演唱得	MUSIC_SEARCH	TITLE:冲破封锁线
凌晨三点的歌名啥意思	MUSIC_SEARCH	TITLE:凌晨三点
凤凰传奇的歌曲	MUSIC_SEARCH	ARTIST_OR_COMPOSER:凤凰传奇
凤飞飞的歌好听不好听	MUSIC_SEARCH	ARTIST_OR_COMPOSER:凤飞飞
刀郎唱的歌有什么	MUSIC_SEARCH	ARTIST_OR_COMPOSER:刀郎
刀郎的歌有多少首	MUSIC_SEARCH	ARTIST_OR_COMPOSER:刀郎
分分合合这个专辑是谁做的	MUSIC_SEARCH	ALBUMNAME:分分合合
分心这首歌是什么时候演出的	MUSIC_SEARCH	TITLE:分心
分手快乐这个专辑怎么样	MUSIC_SEARCH	ALBUMNAME:分手快乐
分手快乐这首歌是不是很有名	MUSIC_SEARCH	TITLE:分手快乐
分手的那天的歌词是什么	MUSIC_SEARCH	TITLE:分手的那天
分手要狠是不是比较好听	MUSIC_SEARCH	TITLE:分手要狠
列出张恒远的歌曲	MUSIC_SEARCH	ARTIST_OR_COMPOSER:张恒远
列出曲婉婷演唱的所有的歌	MUSIC_SEARCH	ARTIST_OR_COMPOSER:曲婉婷
列出来所有的英文歌曲	MUSIC_SEARCH	GENRE:英文歌曲
列出来有的粤语歌曲	MUSIC_SEARCH	GENRE:粤语歌曲
列出梁军诺演唱的歌曲们	MUSIC_SEARCH	ARTIST_OR_COMPOSER:梁军诺
刘德华的歌曲	MUSIC_SEARCH	ARTIST_OR_COMPOSER:刘德华
刘浩龙的专辑列表	MUSIC_SEARCH	ARTIST_OR_COMPOSER:刘浩龙
刘玲玲唱过哀怜吗	MUSIC_SEARCH	ARTIST_OR_COMPOSER:刘玲玲	TITLE:哀怜
刘雅婷的歌都怎么样	MUSIC_SEARCH	ARTIST_OR_COMPOSER:刘雅婷
初爱这张专辑最近很火么	MUSIC_SEARCH	ALBUMNAME:初爱
初爱里的音乐歌词都是谁写的	MUSIC_SEARCH	ALBUMNAME:初爱
初音未来的歌	MUSIC_SEARCH	ARTIST_OR_COMPOSER:初音未来
初音未来的歌曲	MUSIC_SEARCH	ARTIST_OR_COMPOSER:初音未来
别人都说我们会分开的歌词是什么	MUSIC_SEARCH	TITLE:别人都说我们会分开
别怕是谁作的曲	MUSIC_SEARCH	TITLE:别怕
别怪她的曲子是抄的什么歌	MUSIC_SEARCH	TITLE:别怪她
别让情两难的曲子是抄的什么歌	MUSIC_SEARCH	TITLE:别让情两难
别说多情好是最近才出的歌么	MUSIC_SEARCH	TITLE:别说多情好
到死都要18岁的歌曲风格是什么	MUSIC_SEARCH	ALBUMNAME:到死都要18岁
到死都要18岁里面全是什么类型的歌	MUSIC_SEARCH	ALBUMNAME:到死都要18岁
到死都要18岁里面的歌曲都有什么音乐元素	MUSIC_SEARCH	ALBUMNAME:到死都要18岁
到海边的歌曲分类是什么	MUSIC_SEARCH	TITLE:到海边
前两首歌的歌曲信息	MUSIC_PLAY	ANAPHOR:前两首歌
前苏联的乐曲都好听么	MUSIC_SEARCH	GENRE:前苏联的乐曲
动感播放列表	MUSIC_SEARCH	GENRE:动感
北京之夏这首歌流行么	MUSIC_SEARCH	TITLE:北京之夏
十一月的肖邦发行当天的销量如何	MUSIC_SEARCH	ALBUMNAME:十一月的肖邦
十一月的肖邦是哪年发行的	MUSIC_SEARCH	ALBUMNAME:十一月的肖邦
十二新作的歌曲主要是由谁演唱的	MUSIC_SEARCH	ALBUMNAME:十二新作
十二新作里有几首歌	MUSIC_SEARCH	ALBUMNAME:十二新作
十二新作里面歌曲的风格是什么	MUSIC_SEARCH	ALBUMNAME:十二新作
十光年里面的歌曲都有什么	MUSIC_SEARCH	ALBUMNAME:十光年
十有八九这首歌什么时候发行的	MUSIC_SEARCH	TITLE:十有八九
半边生命这个专辑是谁做的	MUSIC_SEARCH	ALBUMNAME:半边生命
单色冰激凌这个专辑怎么样	MUSIC_SEARCH	ALBUMNAME:单色冰激凌
单行道的曲子是抄的什么歌	MUSIC_SEARCH	TITLE:单行道
即使没法讲是不是在世界各地都流行的歌曲	MUSIC_SEARCH	TITLE:即使没法讲
原味组合的昨迟人	MUSIC_SEARCH	ARTIST_OR_COMPOSER:原味组合	TITLE:昨迟人
原子鏸唱过的羽毛	MUSIC_SEARCH	ARTIST_OR_COMPOSER:原子鏸	TITLE:羽毛
原谅我就是这样的女生的曲子是抄的哪首歌	MUSIC_SEARCH	TITLE:原谅我就是这样的女生
参加亲爱的路人录制的歌手都有谁	MUSIC_SEARCH	ALBUMNAME:亲爱的路人
参加可爱的宝贝录制的歌手都有谁	MUSIC_SEARCH	ALBUMNAME:可爱的宝贝
参加范特西录制的歌手都有谁	MUSIC_SEARCH	ALBUMNAME:范特西
参加飞儿乐团录制的歌手都有谁	MUSIC_SEARCH	ALBUMNAME:飞儿乐团
双陈记的作词家是什么	MUSIC_SEARCH	TITLE:双陈记
反町隆史的专辑列表	MUSIC_SEARCH	ARTIST_OR_COMPOSER:反町隆史
变心的玫瑰是哪个著名作词家写的	MUSIC_SEARCH	TITLE:变心的玫瑰
口水多过茶这首歌的风格是什么	MUSIC_SEARCH	TITLE:口水多过茶
只为了你是什么年代的歌曲	MUSIC_SEARCH	TITLE:只为了你
只想做你的男人是哪个电视剧的片头曲	MUSIC_SEARCH	TITLE:只想做你的男人
只有情永在唱的是谁的故事	MUSIC_SEARCH	TITLE:只有情永在
只要有你很好听么	MUSIC_SEARCH	TITLE:只要有你
可以相信的朋友适不适合老年人听	MUSIC_SEARCH	TITLE:可以相信的朋友
可否多一吻是不是八十年代的经典老歌	MUSIC_SEARCH	year:八十年代	GENRE:经典老歌	TITLE:可否多一吻
可敬的对手这首歌所在的专辑是什么时候发行的	MUSIC_SEARCH	TITLE:可敬的对手
可歌可泣属于什么人群会喜欢的歌曲	MUSIC_SEARCH	TITLE:可歌可泣
可爱的宝贝是什么时候发行的	MUSIC_SEARCH	ALBUMNAME:可爱的宝贝
可爱的宝贝的歌曲是不是都是情歌	MUSIC_SEARCH	GENRE:情歌	ALBUMNAME:可爱的宝贝
可爱的宝贝这个专辑里的歌都是谁写的	MUSIC_SEARCH	ALBUMNAME:可爱的宝贝
可爱的宝贝里有几首歌	MUSIC_SEARCH	ALBUMNAME:可爱的宝贝
可爱的宝贝里的音乐歌词都是谁写的	MUSIC_SEARCH	ALBUMNAME:可爱的宝贝
可爱的宝贝里面的歌曲的曲风是什么	MUSIC_SEARCH	ALBUMNAME:可爱的宝贝
可爱的宝贝里面的歌曲都有什么	MUSIC_SEARCH	ALBUMNAME:可爱的宝贝
台北的天空的词是哪首古诗	MUSIC_SEARCH	TITLE:台北的天空
台湾歌曲歌组	MUSIC_SEARCH	GENRE:台湾歌曲
右手边是什么时候发行的	MUSIC_SEARCH	ALBUMNAME:右手边
右手边这个音乐专辑很流行么	MUSIC_SEARCH	ALBUMNAME:右手边
叶志强专辑的信息	MUSIC_SEARCH	ARTIST_OR_COMPOSER:叶志强
叶惠美什么时候发行	MUSIC_SEARCH	ALBUMNAME:叶惠美
叶惠美是周杰伦的专辑么	MUSIC_SEARCH	ARTIST_OR_COMPOSER:周杰伦	ALBUMNAME:叶惠美
叶惠美的歌曲内容都是什么	MUSIC_SEARCH	ALBUMNAME:叶惠美
叶惠美这个唱片最近很火么	MUSIC_SEARCH	ALBUMNAME:叶惠美
叶惠美这个音乐专辑很流行么	MUSIC_SEARCH	ALBUMNAME:叶惠美
叶惠美这张专辑里有哪几首歌	MUSIC_SEARCH	ALBUMNAME:叶惠美
叶玉卿唱过的爱上寂寞	MUSIC_SEARCH	ARTIST_OR_COMPOSER:叶玉卿	TITLE:爱上寂寞
吃火锅是什么类型的歌曲啊	MUSIC_SEARCH	TITLE:吃火锅
吉杰的那首快乐精灵	MUSIC_SEARCH	ARTIST_OR_COMPOSER:吉杰	TITLE:快乐精灵
后两首歌是什么来着	MUSIC_PLAY	ANAPHOR:后两首歌
后弦播放列表	MUSIC_SEARCH	ARTIST_OR_COMPOSER:后弦
向伤心告别的词是哪首宋词	MUSIC_SEARCH	TITLE:向伤心告别
吕方的歌查找	MUSIC_SEARCH	ARTIST_OR_COMPOSER:吕方
听说你爱我这首歌是什么时候出的	MUSIC_SEARCH	TITLE:听说你爱我
吴佳展最新专辑是什么	MUSIC_SEARCH	ARTIST_OR_COMPOSER:吴佳展
吴昊歌组	MUSIC_SEARCH	ARTIST_OR_COMPOSER:吴昊
吻乐队播放列表	MUSIC_SEARCH	ARTIST_OR_COMPOSER:吻乐队
告诉妈妈唱的是谁的故事	MUSIC_SEARCH	TITLE:告诉妈妈
告诉张学友的歌曲都有什么	MUSIC_SEARCH	ARTIST_OR_COMPOSER:张学友
告诉我11月的肖邦的发行年份	MUSIC_SEARCH	ALBUMNAME:11月的肖邦
告诉我11月的肖邦这张专辑的发行公司是什么	MUSIC_SEARCH	ALBUMNAME:11月的肖邦
告诉我11月的肖邦都有什么类型的音乐	MUSIC_SEARCH	ALBUMNAME:11月的肖邦
告诉我11月的肖邦里面有哪几首歌曲	MUSIC_SEARCH	ALBUMNAME:11月的肖邦
告诉我12新作的发行年份	MUSIC_SEARCH	ALBUMNAME:12新作
告诉我12新作这个唱片的价格是多少	MUSIC_SEARCH	ALBUMNAME:12新作
告诉我12新作里面有哪种歌曲	MUSIC_SEARCH	ALBUMNAME:12新作
告诉我一些关于不停站的信息	MUSIC_SEARCH	TITLE:不停站
告诉我一些关于咬唇的信息	MUSIC_SEARCH	TITLE:咬唇
告诉我一些关于城堡的事情	MUSIC_SEARCH	TITLE:城堡
告诉我一些关于忽略的事情	MUSIC_SEARCH	TITLE:忽略
告诉我一些关于特别的爱给特别的你的事情	MUSIC_SEARCH	TITLE:特别的爱给特别的你
告诉我一些关于袜子与鞋的信息	MUSIC_SEARCH	TITLE:袜子与鞋
告诉我一些关于飞行城市的事情	MUSIC_SEARCH	TITLE:飞行城市
告诉我一些关于黑暗中漫舞的信息	MUSIC_SEARCH	TITLE:黑暗中漫舞
告诉我一人同游的节奏快不快	MUSIC_SEARCH	TITLE:一人同游
告诉我一剪梅是哪个年代的	MUSIC_SEARCH	TITLE:一剪梅
告诉我一支花是什么样的歌	MUSIC_SEARCH	TITLE:一支花
告诉我一生一世的节奏快么	MUSIC_SEARCH	TITLE:一生一世
告诉我一起长大这个专辑的主题是什么	MUSIC_SEARCH	ALBUMNAME:一起长大
告诉我一起长大里面有什么歌	MUSIC_SEARCH	ALBUMNAME:一起长大
告诉我一首心歌里面有什么歌	MUSIC_SEARCH	ALBUMNAME:一首心歌
告诉我七情六欲的内容里有什么	MUSIC_SEARCH	TITLE:七情六欲
告诉我七里香是谁的	MUSIC_SEARCH	ALBUMNAME:七里香
告诉我三天三夜这张专辑的发行公司是什么	MUSIC_SEARCH	ALBUMNAME:三天三夜
告诉我下首歌叫啥	MUSIC_PLAY	ANAPHOR:下首歌
告诉我不会分离是什么时候发行的	MUSIC_SEARCH	ALBUMNAME:不会分离
告诉我不会分离这张专辑里有多少首歌	MUSIC_SEARCH	ALBUMNAME:不会分离
告诉我不会分离里面歌曲的风格	MUSIC_SEARCH	ALBUMNAME:不会分离
告诉我不会分离里面的歌曲是不是属于慢摇滚	MUSIC_SEARCH	GENRE:慢摇滚	ALBUMNAME:不会分离
告诉我不怕你不爱我属于哪种类型的音乐	MUSIC_SEARCH	TITLE:不怕你不爱我
告诉我不离不弃是什么风格的歌曲	MUSIC_SEARCH	TITLE:不离不弃
告诉我不要在脸上留下眼泪这首歌的发行日期	MUSIC_SEARCH	TITLE:不要在脸上留下眼泪
告诉我专辑右手边的制作公司是什么	MUSIC_SEARCH	ALBUMNAME:右手边
告诉我专辑排行有没有十首歌	MUSIC_SEARCH	ALBUMNAME:专辑排行
告诉我专辑梁祝下世传奇的制作公司是什么	MUSIC_SEARCH	ALBUMNAME:梁祝下世传奇
告诉我专辑火力全开的制作公司是什么	MUSIC_SEARCH	ALBUMNAME:火力全开
告诉我专辑能不能的制作公司是什么	MUSIC_SEARCH	ALBUMNAME:能不能
告诉我习惯了是哪个作曲家写的曲	MUSIC_SEARCH	TITLE:习惯了
告诉我亲爱的宝贝是谁写的歌	MUSIC_SEARCH	TITLE:亲爱的宝贝
告诉我亲爱的路人的唱片信息	MUSIC_SEARCH	ALBUMNAME:亲爱的路人
告诉我亲爱的路人这个专辑的主题是什么	MUSIC_SEARCH	ALBUMNAME:亲爱的路人
告诉我什么年代流行夜未眠这首歌	MUSIC_SEARCH	TITLE:夜未眠
告诉我什么年代流行怀念过去这首歌	MUSIC_SEARCH	TITLE:怀念过去
告诉我什么年代流行望一望这首歌	MUSIC_SEARCH	TITLE:望一望
告诉我什么年代流行泪的告白这首歌	MUSIC_SEARCH	TITLE:泪的告白
告诉我什么都没留是谁的哪首专辑里面的	MUSIC_SEARCH	TITLE:什么都没留
告诉我今年有什么新歌么	MUSIC_SEARCH	year:今年
告诉我从哪儿买到叶惠美这个唱片	MUSIC_SEARCH	ALBUMNAME:叶惠美
告诉我从哪儿买到想你的距离这个唱片	MUSIC_SEARCH	ALBUMNAME:想你的距离
告诉我从哪儿买到月球漫步这个唱片	MUSIC_SEARCH	ALBUMNAME:月球漫步
告诉我从哪儿买到致纯静这个唱片	MUSIC_SEARCH	ALBUMNAME:致纯静
告诉我从容的下载量是什么	MUSIC_SEARCH	TITLE:从容
告诉我以爱之名里面有什么歌	MUSIC_SEARCH	ALBUMNAME:以爱之名
告诉我会飞的贼里面有几首原创歌曲	MUSIC_SEARCH	ALBUMNAME:会飞的贼
告诉我何必再拖这个专辑的一些信息	MUSIC_SEARCH	ALBUMNAME:何必再拖
告诉我作阵飞的内容里有什么	MUSIC_SEARCH	TITLE:作阵飞
告诉我你像个孩子的中文版的歌词	MUSIC_SEARCH	TITLE:你像个孩子
告诉我你好吗的歌曲属于什么分类	MUSIC_SEARCH	ALBUMNAME:你好吗
告诉我你是武松我是虎的发行日期是什么	MUSIC_SEARCH	TITLE:你是武松我是虎
告诉我你是答案属于什么类型	MUSIC_SEARCH	TITLE:你是答案
告诉我你潇洒我漂亮属于哪种类型的音乐	MUSIC_SEARCH	TITLE:你潇洒我漂亮
告诉我依然范特西这张专辑的发行公司是什么	MUSIC_SEARCH	ALBUMNAME:依然范特西
告诉我信自己这首歌有多长	MUSIC_SEARCH	TITLE:信自己
告诉我光的发行日期	MUSIC_SEARCH	ALBUMNAME:光
告诉我光良的歌是不是好	MUSIC_SEARCH	ARTIST_OR_COMPOSER:光良
告诉我光这个专辑的主题是什么	MUSIC_SEARCH	ALBUMNAME:光
告诉我全经典这张专辑有没有名	MUSIC_SEARCH	ALBUMNAME:全经典
告诉我八度空间这个专辑的歌曲名字是什么	MUSIC_SEARCH	ALBUMNAME:八度空间
告诉我兰陵王这张专辑是哪年的	MUSIC_SEARCH	ALBUMNAME:兰陵王
告诉我共同言语是哪个作曲家写的曲	MUSIC_SEARCH	TITLE:共同言语
告诉我关于初恋粉色系的信息	MUSIC_SEARCH	TITLE:初恋粉色系
告诉我关于叶惠美的一些信息	MUSIC_SEARCH	ALBUMNAME:叶惠美
告诉我关于就叫我孩子这首歌的信息	MUSIC_SEARCH	TITLE:就叫我孩子
告诉我关于尽头的专辑的信息	MUSIC_SEARCH	TITLE:尽头
告诉我关于恋人岛的专辑的信息	MUSIC_SEARCH	TITLE:恋人岛
告诉我关于我要一种感觉的信息	MUSIC_SEARCH	TITLE:我要一种感觉
告诉我关于搞不清楚的专辑的信息	MUSIC_SEARCH	TITLE:搞不清楚
告诉我关于早安晨之美这首歌的信息	MUSIC_SEARCH	TITLE:早安晨之美
告诉我关于最后的茱丽叶这首歌的信息	MUSIC_SEARCH	TITLE:最后的茱丽叶
告诉我关于梦幻小夜曲的信息	MUSIC_SEARCH	TITLE:梦幻小夜曲
告诉我关于梦想的专辑的信息	MUSIC_SEARCH	TITLE:梦想
告诉我关于法语歌曲的信息	MUSIC_SEARCH	GENRE:法语歌曲
告诉我关于海阔天空的一些信息	MUSIC_SEARCH	ALBUMNAME:海阔天空
告诉我关于深情相拥的信息	MUSIC_SEARCH	TITLE:深情相拥
告诉我关于火力全开的一些信息	MUSIC_SEARCH	ALBUMNAME:火力全开
告诉我关于茶马古道这首歌的信息	MUSIC_SEARCH	TITLE:茶马古道
告诉我关于跨出界的一些信息	MUSIC_SEARCH	ALBUMNAME:跨出界
告诉我其实你不懂我的心的内容里有什么	MUSIC_SEARCH	TITLE:其实你不懂我的心
告诉我其实你不用去远方是谁的歌	MUSIC_SEARCH	TITLE:其实你不用去远方
告诉我减肥拳这首歌的发行日期	MUSIC_SEARCH	TITLE:减肥拳
告诉我分手倒数是在哪个专辑里	MUSIC_SEARCH	TITLE:分手倒数
告诉我初爱这个专辑的一些信息	MUSIC_SEARCH	ALBUMNAME:初爱
告诉我别离开我这首歌都说了什么	MUSIC_SEARCH	TITLE:别离开我
告诉我别说狠的发行日期是什么	MUSIC_SEARCH	TITLE:别说狠
告诉我别问我爱谁这首歌有多长	MUSIC_SEARCH	TITLE:别问我爱谁
告诉我到死都要18岁是什么时候发行的	MUSIC_SEARCH	ALBUMNAME:到死都要18岁
告诉我到死都要18岁里面有几首原创歌曲	MUSIC_SEARCH	ALBUMNAME:到死都要18岁
告诉我到死都要18岁里面都有哪几首歌	MUSIC_SEARCH	ALBUMNAME:到死都要18岁
告诉我前一首歌叫什么	MUSIC_PLAY	ANAPHOR:前一首歌
告诉我十一月的肖邦的歌曲属于什么分类	MUSIC_SEARCH	ALBUMNAME:十一月的肖邦
告诉我十二新作这个专辑里面有几首摇滚乐	MUSIC_SEARCH	GENRE:摇滚乐	ALBUMNAME:十二新作
告诉我十二新作里面有哪几首歌曲	MUSIC_SEARCH	ALBUMNAME:十二新作
告诉我午夜剧这首歌的歌词是什么	MUSIC_SEARCH	TITLE:午夜剧
告诉我半点是什么类别的歌曲	MUSIC_SEARCH	TITLE:半点
告诉我句句我爱你的专辑是谁的	MUSIC_SEARCH	TITLE:句句我爱你
告诉我只想被你爱的内容里有什么	MUSIC_SEARCH	TITLE:只想被你爱
告诉我可爱的宝贝的歌曲属于什么分类	MUSIC_SEARCH	ALBUMNAME:可爱的宝贝
告诉我右手边的唱片信息	MUSIC_SEARCH	ALBUMNAME:右手边
告诉我右手边这个专辑的歌曲名字是什么	MUSIC_SEARCH	ALBUMNAME:右手边
告诉我右手边里面歌曲的风格	MUSIC_SEARCH	ALBUMNAME:右手边
告诉我叶惠美这张专辑有没有名	MUSIC_SEARCH	ALBUMNAME:叶惠美
告诉我叶惠美里面都有哪几首歌	MUSIC_SEARCH	ALBUMNAME:叶惠美
告诉我后一首歌是哪个	MUSIC_PLAY	ANAPHOR:后一首歌
告诉我味道的节奏快么	MUSIC_SEARCH	TITLE:味道
告诉我哭不出来的歌曲分类	MUSIC_SEARCH	TITLE:哭不出来
告诉我唱我不懂的歌手	MUSIC_SEARCH	TITLE:我不懂
告诉我唱月黑风高的歌手	MUSIC_SEARCH	TITLE:月黑风高
告诉我唱沉睡的木吉他的歌手	MUSIC_SEARCH	TITLE:沉睡的木吉他
告诉我唱苦浪漫的歌手	MUSIC_SEARCH	TITLE:苦浪漫
告诉我嘿嘿嘿是什么风格的歌曲	MUSIC_SEARCH	TITLE:嘿嘿嘿
告诉我回到往日好时光是谁写的歌	MUSIC_SEARCH	TITLE:回到往日好时光
告诉我回忆里的疯狂是谁的	MUSIC_SEARCH	ALBUMNAME:回忆里的疯狂
告诉我回忆里的疯狂里面有哪种歌曲	MUSIC_SEARCH	ALBUMNAME:回忆里的疯狂
告诉我因你而在是什么时候发行的	MUSIC_SEARCH	ALBUMNAME:因你而在
告诉我因你而在这个专辑的作者	MUSIC_SEARCH	ALBUMNAME:因你而在
告诉我园游会是谁的歌	MUSIC_SEARCH	TITLE:园游会
告诉我夏之旅是哪个歌唱家演唱的	MUSIC_SEARCH	TITLE:夏之旅
告诉我夏夕空属于哪种类型的音乐	MUSIC_SEARCH	TITLE:夏夕空
告诉我天亮了这首歌是谁写在什么时候写的	MUSIC_SEARCH	TITLE:天亮了
告诉我天使之翼的唱片信息	MUSIC_SEARCH	ALBUMNAME:天使之翼
告诉我天使之翼这个专辑的作者	MUSIC_SEARCH	ALBUMNAME:天使之翼
告诉我天堂里没有车来车往的下载量是什么	MUSIC_SEARCH	TITLE:天堂里没有车来车往
告诉我天天看到你是什么风格的歌曲	MUSIC_SEARCH	TITLE:天天看到你
告诉我天空之城是什么样的歌	MUSIC_SEARCH	TITLE:天空之城
告诉我太天真是谁的专辑	MUSIC_SEARCH	ALBUMNAME:太天真
告诉我好想你是谁的专辑	MUSIC_SEARCH	ALBUMNAME:好想你
告诉我好的情人有没有十首歌	MUSIC_SEARCH	ALBUMNAME:好的情人
告诉我如果下雪的歌曲评论怎么样	MUSIC_SEARCH	TITLE:如果下雪
告诉我如果没有明天的下载量是什么	MUSIC_SEARCH	TITLE:如果没有明天
告诉我存在的力量里面有哪种歌曲	MUSIC_SEARCH	ALBUMNAME:存在的力量
告诉我宁愿爱你是谁的哪首专辑里面的	MUSIC_SEARCH	TITLE:宁愿爱你
告诉我宅无处不在这个专辑的一些信息	MUSIC_SEARCH	ALBUMNAME:宅无处不在
告诉我宅无处不在都有什么类型的音乐	MUSIC_SEARCH	ALBUMNAME:宅无处不在
告诉我守约的专辑是谁的	MUSIC_SEARCH	TITLE:守约
告诉我寂寞的眼属于谁的哪个专辑	MUSIC_SEARCH	TITLE:寂寞的眼
告诉我寒雨的下载量是什么	MUSIC_SEARCH	TITLE:寒雨
告诉我小丑是谁的歌	MUSIC_SEARCH	TITLE:小丑
告诉我差一分钟最近是不是很火	MUSIC_SEARCH	TITLE:差一分钟
告诉我幸福选择题这个专辑的歌曲名字是什么	MUSIC_SEARCH	ALBUMNAME:幸福选择题
告诉我幸福选择题都有什么类型的音乐	MUSIC_SEARCH	ALBUMNAME:幸福选择题
告诉我幸福选择题里面有哪几首歌曲	MUSIC_SEARCH	ALBUMNAME:幸福选择题
告诉我当地时间是谁唱的	MUSIC_SEARCH	TITLE:当地时间
告诉我当女飞侠爱上万能侠是哪个作曲家写的曲	MUSIC_SEARCH	TITLE:当女飞侠爱上万能侠
告诉我心愿的歌曲分类	MUSIC_SEARCH	TITLE:心愿
告诉我心爱宝贝这首歌是不是比较火	MUSIC_SEARCH	TITLE:心爱宝贝
告诉我心甘情愿的歌曲评论怎么样	MUSIC_SEARCH	TITLE:心甘情愿
告诉我总是的节奏快么	MUSIC_SEARCH	TITLE:总是
告诉我恋爱是哪个组合演唱的曲目	MUSIC_SEARCH	TITLE:恋爱
告诉我情感蒸发是哪个歌唱家演唱的	MUSIC_SEARCH	TITLE:情感蒸发
告诉我惊叹号这个专辑里面有几首摇滚乐	MUSIC_SEARCH	GENRE:摇滚乐	ALBUMNAME:惊叹号
告诉我惊叹号这张专辑是哪年的	MUSIC_SEARCH	ALBUMNAME:惊叹号
告诉我惯性背叛这首歌是谁写在什么时候写的	MUSIC_SEARCH	TITLE:惯性背叛
告诉我想你的习惯是哪个年代的	MUSIC_SEARCH	TITLE:想你的习惯
告诉我想你的距离的唱片信息	MUSIC_SEARCH	ALBUMNAME:想你的距离
告诉我想你的距离这个专辑里面有几首摇滚乐	MUSIC_SEARCH	GENRE:摇滚乐	ALBUMNAME:想你的距离
告诉我想你的距离这张专辑的发行公司是什么	MUSIC_SEARCH	ALBUMNAME:想你的距离
告诉我感情用事的发行日期是什么	MUSIC_SEARCH	TITLE:感情用事
告诉我感谢爱人是谁的专辑	MUSIC_SEARCH	ALBUMNAME:感谢爱人
告诉我我不愿意是什么类别的歌曲	MUSIC_SEARCH	TITLE:我不愿意
告诉我我的未来这首歌是不是比较火	MUSIC_SEARCH	TITLE:我的未来
告诉我我祈求的专辑是谁的	MUSIC_SEARCH	TITLE:我祈求
告诉我我还记得是哪个组合演唱的曲目	MUSIC_SEARCH	TITLE:我还记得
告诉我手心是在哪个专辑里	MUSIC_SEARCH	TITLE:手心
告诉我执着这首歌的发行日期	MUSIC_SEARCH	TITLE:执着
告诉我技术性击倒属于什么类型	MUSIC_SEARCH	TITLE:技术性击倒
告诉我挑信这张专辑里有多少首歌	MUSIC_SEARCH	ALBUMNAME:挑信
告诉我摇滚吧情歌里面有几首原创歌曲	MUSIC_SEARCH	ALBUMNAME:摇滚吧情歌
告诉我放心不下的发行年份	MUSIC_SEARCH	ALBUMNAME:放心不下
告诉我放心不下这个专辑的主题是什么	MUSIC_SEARCH	ALBUMNAME:放心不下
告诉我无名之辈这首歌是谁写在什么时候写的	MUSIC_SEARCH	TITLE:无名之辈
告诉我无眠是谁的哪首专辑里面的	MUSIC_SEARCH	TITLE:无眠
告诉我早餐派这首歌是不是比较火	MUSIC_SEARCH	TITLE:早餐派
告诉我旺得福是什么时候发行的	MUSIC_SEARCH	ALBUMNAME:旺得福
告诉我星楼的星座是谁唱的	MUSIC_SEARCH	TITLE:星楼的星座
告诉我晃晃悠悠的发行日期是什么	MUSIC_SEARCH	TITLE:晃晃悠悠
告诉我最后的风度是谁的歌	MUSIC_SEARCH	TITLE:最后的风度
告诉我月球漫步这张专辑是谁的	MUSIC_SEARCH	ALBUMNAME:月球漫步
告诉我朋友别哭属于谁的哪个专辑	MUSIC_SEARCH	TITLE:朋友别哭
告诉我木兰情的节奏快不快	MUSIC_SEARCH	TITLE:木兰情
告诉我杰伦有没有十首歌	MUSIC_SEARCH	ALBUMNAME:杰伦
告诉我杰伦里面有哪几首歌曲	MUSIC_SEARCH	ALBUMNAME:杰伦
告诉我林俊杰的歌的类型	MUSIC_SEARCH	ARTIST_OR_COMPOSER:林俊杰
告诉我桐花这个专辑的作者	MUSIC_SEARCH	ALBUMNAME:桐花
告诉我桐花这张专辑有没有名	MUSIC_SEARCH	ALBUMNAME:桐花
告诉我梦的旅途是谁写的歌	MUSIC_SEARCH	TITLE:梦的旅途
告诉我歌曲不能跟情人说的话是谁的	MUSIC_SEARCH	TITLE:不能跟情人说的话
告诉我歌曲十八岁是谁的	MUSIC_SEARCH	TITLE:十八岁
告诉我歌曲子曰是谁的	MUSIC_SEARCH	TITLE:子曰
告诉我歌曲让懂你的人爱你是谁的	MUSIC_SEARCH	TITLE:让懂你的人爱你
告诉我水中这首歌有多长	MUSIC_SEARCH	TITLE:水中
告诉我永远的永远这个唱片的价格是多少	MUSIC_SEARCH	ALBUMNAME:永远的永远
告诉我洗牌的歌曲评论怎么样	MUSIC_SEARCH	TITLE:洗牌
告诉我火力全开这个专辑里面有几首摇滚乐	MUSIC_SEARCH	GENRE:摇滚乐	ALBUMNAME:火力全开
告诉我爱上你不只是我的错误是从哪个专辑里来的	MUSIC_SEARCH	TITLE:爱上你不只是我的错误
告诉我爱从昨夜就停了这首歌是不是比较火	MUSIC_SEARCH	TITLE:爱从昨夜就停了
告诉我爱你的那个这首歌的歌词是什么	MUSIC_SEARCH	TITLE:爱你的那个
告诉我爱在你伤口是哪个年代的	MUSIC_SEARCH	TITLE:爱在你伤口
告诉我爱情傻瓜属于谁的哪个专辑	MUSIC_SEARCH	TITLE:爱情傻瓜
告诉我爱情错觉最近是不是很火	MUSIC_SEARCH	TITLE:爱情错觉
告诉我爱我不爱是什么样的歌	MUSIC_SEARCH	TITLE:爱我不爱
告诉我爱我就告诉我这首歌都说了什么	MUSIC_SEARCH	TITLE:爱我就告诉我
告诉我爱有什么不好的歌曲分类	MUSIC_SEARCH	TITLE:爱有什么不好
告诉我爱的力量这张专辑是哪年的	MUSIC_SEARCH	ALBUMNAME:爱的力量
告诉我爱的力量这张专辑有没有名	MUSIC_SEARCH	ALBUMNAME:爱的力量
告诉我爱的筹码是谁的专辑	MUSIC_SEARCH	ALBUMNAME:爱的筹码
告诉我爱的筹码这个专辑的一些信息	MUSIC_SEARCH	ALBUMNAME:爱的筹码
告诉我爱的筹码这张专辑是哪年的	MUSIC_SEARCH	ALBUMNAME:爱的筹码
告诉我玛莉与伟业是哪个年代的	MUSIC_SEARCH	TITLE:玛莉与伟业
告诉我现在最流行的歌曲	MUSIC_SEARCH
告诉我用爱将心偷是哪个歌唱家演唱的	MUSIC_SEARCH	TITLE:用爱将心偷
告诉我用马来西亚的天气来说爱你的歌曲评论怎么样	MUSIC_SEARCH	TITLE:用马来西亚的天气来说爱你
告诉我电影院这首歌的歌词是什么	MUSIC_SEARCH	TITLE:电影院
告诉我盛开的发行日期	MUSIC_SEARCH	ALBUMNAME:盛开
告诉我盛开这个唱片的价格是多少	MUSIC_SEARCH	ALBUMNAME:盛开
告诉我相信相依是谁唱的	MUSIC_SEARCH	TITLE:相信相依
告诉我相见恨晚的歌曲分类	MUSIC_SEARCH	TITLE:相见恨晚
告诉我看不见的中文版的歌词	MUSIC_SEARCH	TITLE:看不见
告诉我看海的发行日期	MUSIC_SEARCH	ALBUMNAME:看海
告诉我瞎了聋了是在哪个专辑里	MUSIC_SEARCH	TITLE:瞎了聋了
告诉我祖先的阴影的节奏快不快	MUSIC_SEARCH	TITLE:祖先的阴影
告诉我神秘嘉宾都有什么类型的音乐	MUSIC_SEARCH	ALBUMNAME:神秘嘉宾
告诉我空城计这首歌有多长	MUSIC_SEARCH	TITLE:空城计
告诉我笑着哭是谁的哪首专辑里面的	MUSIC_SEARCH	TITLE:笑着哭
告诉我第一个找你枫的节奏快不快	MUSIC_SEARCH	TITLE:第一个找你枫
告诉我等等这张专辑是谁的	MUSIC_SEARCH	ALBUMNAME:等等
告诉我等等里面歌曲的风格	MUSIC_SEARCH	ALBUMNAME:等等
告诉我粮票属于什么类型	MUSIC_SEARCH	TITLE:粮票
告诉我红河村是谁唱的	MUSIC_SEARCH	TITLE:红河村
告诉我纯属意外是谁的	MUSIC_SEARCH	ALBUMNAME:纯属意外
告诉我给你们的一封信这首歌的歌词是什么	MUSIC_SEARCH	TITLE:给你们的一封信
告诉我给你幸福我有自信最近是不是很火	MUSIC_SEARCH	TITLE:给你幸福我有自信
告诉我给我一首歌的时间是什么样的歌	MUSIC_SEARCH	TITLE:给我一首歌的时间
告诉我维多利亚的爱这首歌都说了什么	MUSIC_SEARCH	TITLE:维多利亚的爱
告诉我美好里面的歌曲是不是属于慢摇滚	MUSIC_SEARCH	GENRE:慢摇滚	ALBUMNAME:美好
告诉我肝胆相照的中文版的歌词	MUSIC_SEARCH	TITLE:肝胆相照
告诉我自闭属于哪种类型的音乐	MUSIC_SEARCH	TITLE:自闭
告诉我致纯静的歌曲属于什么分类	MUSIC_SEARCH	ALBUMNAME:致纯静
告诉我花儿为你开属于什么类型	MUSIC_SEARCH	TITLE:花儿为你开
告诉我花又开好了这张专辑里有多少首歌	MUSIC_SEARCH	ALBUMNAME:花又开好了
告诉我花样年华这个唱片的价格是多少	MUSIC_SEARCH	ALBUMNAME:花样年华
告诉我花样年华里面都有哪几首歌	MUSIC_SEARCH	ALBUMNAME:花样年华
告诉我若不是因为你属于谁的哪个专辑	MUSIC_SEARCH	TITLE:若不是因为你
告诉我范特西的发行日期	MUSIC_SEARCH	ALBUMNAME:范特西
告诉我范特西这个专辑的作者	MUSIC_SEARCH	ALBUMNAME:范特西
告诉我范特西里面的歌曲是不是属于慢摇滚	MUSIC_SEARCH	GENRE:慢摇滚	ALBUMNAME:范特西
告诉我落入西班牙的阿佛洛蒂特这首歌是谁写在什么时候写的	MUSIC_SEARCH	TITLE:落入西班牙的阿佛洛蒂特
告诉我蒙山巍巍碧水长是哪个作曲家写的曲	MUSIC_SEARCH	TITLE:蒙山巍巍碧水长
告诉我蓝色理想这首歌的发行日期	MUSIC_SEARCH	TITLE:蓝色理想
告诉我西太后是在哪个专辑里	MUSIC_SEARCH	TITLE:西太后
告诉我见你好吗里面的歌曲是不是属于慢摇滚	MUSIC_SEARCH	GENRE:慢摇滚	ALBUMNAME:见你好吗
告诉我记得我吗是哪个组合演唱的曲目	MUSIC_SEARCH	TITLE:记得我吗
告诉我请继续任性是什么风格的歌曲	MUSIC_SEARCH	TITLE:请继续任性
告诉我谁唱的射手里面的歌	MUSIC_SEARCH	ALBUMNAME:射手
告诉我谁唱的幸福了然后呢里面的歌	MUSIC_SEARCH	ALBUMNAME:幸福了然后呢
告诉我谁唱的盛开里面的歌	MUSIC_SEARCH	ALBUMNAME:盛开
告诉我谁唱的青春里面的歌	MUSIC_SEARCH	ALBUMNAME:青春
告诉我谁是欧美的最火男歌手	MUSIC_SEARCH	GENRE:欧美
告诉我谈心最近是不是很火	MUSIC_SEARCH	TITLE:谈心
告诉我走生命的路是谁写的歌	MUSIC_SEARCH	TITLE:走生命的路
告诉我跨出界这张专辑是谁的	MUSIC_SEARCH	ALBUMNAME:跨出界
告诉我跨出界里面有什么歌	MUSIC_SEARCH	ALBUMNAME:跨出界
告诉我跨出界里面有哪种歌曲	MUSIC_SEARCH	ALBUMNAME:跨出界
告诉我跨出界里面歌曲的风格	MUSIC_SEARCH	ALBUMNAME:跨出界
告诉我路的尽头是从哪个专辑里来的	MUSIC_SEARCH	TITLE:路的尽头
告诉我跳针舞曲的发行年份	MUSIC_SEARCH	ALBUMNAME:跳针舞曲
告诉我跳针舞曲这张专辑是谁的	MUSIC_SEARCH	ALBUMNAME:跳针舞曲
告诉我这两年内有什么新歌么	MUSIC_SEARCH	year:两年内
告诉我那么爱你为什么的中文版的歌词	MUSIC_SEARCH	TITLE:那么爱你为什么
告诉我郎心似铁是从哪个专辑里来的	MUSIC_SEARCH	TITLE:郎心似铁
告诉我错过里面有几首原创歌曲	MUSIC_SEARCH	ALBUMNAME:错过
告诉我陪你倒数是从哪个专辑里来的	MUSIC_SEARCH	TITLE:陪你倒数
告诉我陪我去流浪有没有十首歌	MUSIC_SEARCH	ALBUMNAME:陪我去流浪
告诉我隐形超人是什么类别的歌曲	MUSIC_SEARCH	TITLE:隐形超人
告诉我青春再见是谁的	MUSIC_SEARCH	ALBUMNAME:青春再见
告诉我青春再见这个专辑的歌曲名字是什么	MUSIC_SEARCH	ALBUMNAME:青春再见
告诉我青春里面都有哪几首歌	MUSIC_SEARCH	ALBUMNAME:青春
告诉我飘飘是什么类别的歌曲	MUSIC_SEARCH	TITLE:飘飘
告诉我高枕无忧的节奏快么	MUSIC_SEARCH	TITLE:高枕无忧
告诉我魔力是哪个组合演唱的曲目	MUSIC_SEARCH	TITLE:魔力
告诉我魔杰座这张专辑里有多少首歌	MUSIC_SEARCH	ALBUMNAME:魔杰座
告诉我麦子的专辑是谁的	MUSIC_SEARCH	TITLE:麦子
告诉我黄昏思情这首歌都说了什么	MUSIC_SEARCH	TITLE:黄昏思情
告诉我黑胶唱片是哪个歌唱家演唱的	MUSIC_SEARCH	TITLE:黑胶唱片
呛司呛司的歌名啥意思	MUSIC_SEARCH	TITLE:呛司呛司
周华健有多少个专辑	MUSIC_SEARCH	ARTIST_OR_COMPOSER:周华健
周国贤的魔杰座	MUSIC_SEARCH	ARTIST_OR_COMPOSER:周国贤	ALBUMNAME:魔杰座
周杰伦有多少个专辑	MUSIC_SEARCH	ARTIST_OR_COMPOSER:周杰伦
周杰伦的歌	MUSIC_SEARCH	ARTIST_OR_COMPOSER:周杰伦
周杰伦的歌曲	MUSIC_SEARCH	ARTIST_OR_COMPOSER:周杰伦
周虹唱过的够钟	MUSIC_SEARCH	ARTIST_OR_COMPOSER:周虹	TITLE:够钟
呼喊是一首新歌么	MUSIC_SEARCH	TITLE:呼喊
命运这首歌是谁唱的	MUSIC_SEARCH	TITLE:命运
和谐中国的歌曲分类是什么	MUSIC_SEARCH	TITLE:和谐中国
和饼干说话的人是哪个电视剧的片头曲	MUSIC_SEARCH	TITLE:和饼干说话的人
咖啡厅的音乐查找一下	MUSIC_SEARCH	GENRE:咖啡厅的音乐
哪个专辑里有一生只为你这首歌	MUSIC_SEARCH	TITLE:一生只为你
哪个专辑里有心里不甜这首歌	MUSIC_SEARCH	TITLE:心里不甜
哪个专辑里有爱的独白这首歌	MUSIC_SEARCH	TITLE:爱的独白
哪个专辑里有空肚食早餐这首歌	MUSIC_SEARCH	TITLE:空肚食早餐
哪个作曲家写的七年的爱	MUSIC_SEARCH	TITLE:七年的爱
哪个作曲家写的反复	MUSIC_SEARCH	TITLE:反复
哪个作曲家写的可爱的车	MUSIC_SEARCH	TITLE:可爱的车
哪个作曲家写的月亮	MUSIC_SEARCH	TITLE:月亮
哪个歌唱家演唱的五月梦	MUSIC_SEARCH	TITLE:五月梦
哪个歌唱家演唱的失忆周末	MUSIC_SEARCH	TITLE:失忆周末
哪个歌唱家演唱的守候	MUSIC_SEARCH	TITLE:守候
哪个歌唱家演唱的永远爱你的人	MUSIC_SEARCH	TITLE:永远爱你的人
哪个歌手演唱的人海中一个你	MUSIC_SEARCH	TITLE:人海中一个你
哪个歌手演唱的动	MUSIC_SEARCH	TITLE:动
哪个歌手演唱的坚强女人心	MUSIC_SEARCH	TITLE:坚强女人心
哪个歌手演唱的我和你的那些年	MUSIC_SEARCH	TITLE:我和你的那些年
哪个组合演唱的只有为你	MUSIC_SEARCH	TITLE:只有为你
哪个组合演唱的幸福港湾	MUSIC_SEARCH	TITLE:幸福港湾
哪个组合演唱的淡淡的歌	MUSIC_SEARCH	TITLE:淡淡的歌
哪个组合演唱的讨厌	MUSIC_SEARCH	TITLE:讨厌
哪些电影用了平行线	MUSIC_SEARCH	TITLE:平行线
哪些电影用了我的快乐	MUSIC_SEARCH	TITLE:我的快乐
哪些电影用了爱不单行	MUSIC_SEARCH	TITLE:爱不单行
哪些电影用了胜利呼唤	MUSIC_SEARCH	TITLE:胜利呼唤
哭诸葛这首歌怎么样	MUSIC_SEARCH	TITLE:哭诸葛
唐妮布莱斯顿唱的雁南飞	MUSIC_SEARCH	ARTIST_OR_COMPOSER:唐妮布莱斯顿	TITLE:雁南飞
唯舞独尊这首歌非常得流行么	MUSIC_SEARCH	TITLE:唯舞独尊
唱外婆的澎湖湾的是谁	MUSIC_SEARCH	TITLE:外婆的澎湖湾
唱恋爱中的我的都有谁	MUSIC_SEARCH	TITLE:恋爱中的我
唱捕风的汉子的是谁	MUSIC_SEARCH	TITLE:捕风的汉子
唱无止境的心痛的都有谁	MUSIC_SEARCH	TITLE:无止境的心痛
唱歌给谁听的词是哪首宋词	MUSIC_SEARCH	TITLE:唱歌给谁听
唱片依然范特西的发行日期是什么	MUSIC_SEARCH	ALBUMNAME:依然范特西
唱片存在的力量的发行日期是什么	MUSIC_SEARCH	ALBUMNAME:存在的力量
唱片想你的距离的发行日期是什么	MUSIC_SEARCH	ALBUMNAME:想你的距离
唱片爱赢了的发行日期是什么	MUSIC_SEARCH	ALBUMNAME:爱赢了
唱美好了生命的是谁	MUSIC_SEARCH	TITLE:美好了生命
唱胭脂红尘的都有谁	MUSIC_SEARCH	TITLE:胭脂红尘
唱轮回的天使的是谁	MUSIC_SEARCH	TITLE:轮回的天使
唱黑暗时代的都有谁	MUSIC_SEARCH	TITLE:黑暗时代
善舞的死者的输情歌	MUSIC_SEARCH	ARTIST_OR_COMPOSER:善舞的死者	TITLE:输情歌
喜悦有哪几个歌手演唱过	MUSIC_SEARCH	TITLE:喜悦
喜欢你现在的样子的歌曲分类是什么	MUSIC_SEARCH	TITLE:喜欢你现在的样子
四个朋友卖多少钱	MUSIC_SEARCH	ALBUMNAME:四个朋友
四个朋友属于什么类型的音乐	MUSIC_SEARCH	ALBUMNAME:四个朋友
四个朋友是阿尔法音乐制作的么	MUSIC_SEARCH	ALBUMNAME:四个朋友
四个朋友这张专辑是几十年代出的	MUSIC_SEARCH	ALBUMNAME:四个朋友
回不到昨天的歌词	MUSIC_SEARCH	TITLE:回不到昨天
回忆信笺这首歌几分钟长	MUSIC_SEARCH	TITLE:回忆信笺
回忆里的疯狂是周杰伦的专辑么	MUSIC_SEARCH	ARTIST_OR_COMPOSER:周杰伦	ALBUMNAME:回忆里的疯狂
回忆里的疯狂这个专辑出自哪个年代	MUSIC_SEARCH	ALBUMNAME:回忆里的疯狂
回忆里的疯狂这个专辑里的歌都是谁写的	MUSIC_SEARCH	ALBUMNAME:回忆里的疯狂
回族姑娘的原版是什么歌	MUSIC_SEARCH	TITLE:回族姑娘
因为爱情这个专辑如何	MUSIC_SEARCH	ALBUMNAME:因为爱情
因你而在在什么年代发行的	MUSIC_SEARCH	ALBUMNAME:因你而在
因你而在是谁的专辑	MUSIC_SEARCH	ALBUMNAME:因你而在
因你而在这张专辑由哪个公司发行的	MUSIC_SEARCH	ALBUMNAME:因你而在
因你而在这里面有什么有名的歌么	MUSIC_SEARCH	ALBUMNAME:因你而在
因你而在里面歌曲的风格是什么	MUSIC_SEARCH	ALBUMNAME:因你而在
因你而在里面都是什么年份的歌曲	MUSIC_SEARCH	ALBUMNAME:因你而在
国家这首歌来自哪个国家	MUSIC_SEARCH	TITLE:国家
圣堂之门的歌曲分类是什么	MUSIC_SEARCH	TITLE:圣堂之门
在我生命里有很多人听么	MUSIC_SEARCH	TITLE:在我生命里
在旅行的路上这个专辑是谁做的	MUSIC_SEARCH	ALBUMNAME:在旅行的路上
圪梁梁有很多人听么	MUSIC_SEARCH	TITLE:圪梁梁
坏脾气是不是周杰伦唱过的	MUSIC_SEARCH	ARTIST_OR_COMPOSER:周杰伦	TITLE:坏脾气
埃尔顿约翰的那首自作自受	MUSIC_SEARCH	ARTIST_OR_COMPOSER:埃尔顿约翰	TITLE:自作自受
城市稻草人的歌曲分类是什么	MUSIC_SEARCH	TITLE:城市稻草人
夕阳无限好都有什么语言的版本	MUSIC_SEARCH	TITLE:夕阳无限好
外婆的老唱片的最曲家是谁	MUSIC_SEARCH	TITLE:外婆的老唱片
多情的路是谁唱的	MUSIC_SEARCH	TITLE:多情的路
大伢乐队唱过的工作	MUSIC_SEARCH	ARTIST_OR_COMPOSER:大伢乐队	GENRE:工作
大喜宙是哪个国家的歌曲	MUSIC_SEARCH	TITLE:大喜宙
大妹子这首歌的评论怎么样	MUSIC_SEARCH	TITLE:大妹子
大导演的作曲家是谁	MUSIC_SEARCH	TITLE:大导演
大空虚的城市是一首情歌么	MUSIC_SEARCH	GENRE:情歌	TITLE:大空虚的城市
大马帮的专辑列表	MUSIC_SEARCH	ARTIST_OR_COMPOSER:大马帮
大麦新专辑	MUSIC_SEARCH	ARTIST_OR_COMPOSER:大麦
天仙配树上的鸟儿成双对这首歌在什么专辑	MUSIC_SEARCH	TITLE:天仙配树上的鸟儿成双对
天使之翼是几几年发行的	MUSIC_SEARCH	ALBUMNAME:天使之翼
天使之翼这个专辑出自哪个年代	MUSIC_SEARCH	ALBUMNAME:天使之翼
天使之翼这个专辑是谁做的	MUSIC_SEARCH	ALBUMNAME:天使之翼
天使之翼这个专辑里的的歌曲类别是什么啊	MUSIC_SEARCH	ALBUMNAME:天使之翼
天使之翼这张专辑是几十年代出的	MUSIC_SEARCH	ALBUMNAME:天使之翼
天使也一样这首歌怎么样啊	MUSIC_SEARCH	TITLE:天使也一样
天使蓝是作做的曲	MUSIC_SEARCH	TITLE:天使蓝
天天想我的歌曲分类是什么	MUSIC_SEARCH	TITLE:天天想我
天炫男孩唱过的柔情歌曲	MUSIC_SEARCH	ARTIST_OR_COMPOSER:天炫男孩	GENRE:柔情歌曲
天生不是情造这个专辑如何	MUSIC_SEARCH	ALBUMNAME:天生不是情造
天蓝的词是哪首古诗	MUSIC_SEARCH	TITLE:天蓝
天马行空算不算是八十年代的歌曲	MUSIC_SEARCH	year:八十年代	TITLE:天马行空
太天真什么时候发行	MUSIC_SEARCH	ALBUMNAME:太天真
太天真是个什么类型的专辑	MUSIC_SEARCH	ALBUMNAME:太天真
太天真里面全是什么类型的歌	MUSIC_SEARCH	ALBUMNAME:太天真
太天真里面是不是都是七十年代的歌	MUSIC_SEARCH	year:七十年代	ALBUMNAME:太天真
太胡闹的原版是什么歌	MUSIC_SEARCH	TITLE:太胡闹
奔向太空是什么乐团的	MUSIC_SEARCH	TITLE:奔向太空
女人如烟是由谁演唱得	MUSIC_SEARCH	TITLE:女人如烟
女人心事去年的发行量是多少	MUSIC_SEARCH	year:去年	ALBUMNAME:女人心事
女人心事是哪年发行的	MUSIC_SEARCH	ALBUMNAME:女人心事
女人心事这个专辑出自哪个歌手	MUSIC_SEARCH	ALBUMNAME:女人心事
女人花是哪个电视剧的片尾曲	MUSIC_SEARCH	TITLE:女人花
女儿情是哪里的歌曲	MUSIC_SEARCH	TITLE:女儿情
女大十八变的词是哪首古诗	MUSIC_SEARCH	TITLE:女大十八变
女生宿舍新专辑	MUSIC_SEARCH	ARTIST_OR_COMPOSER:女生宿舍
她的眼睛会下雨是谁作的词	MUSIC_SEARCH	TITLE:她的眼睛会下雨
好事样样来是什么类型的歌曲啊	MUSIC_SEARCH	TITLE:好事样样来
好汉歌这首歌怎么样	MUSIC_SEARCH	TITLE:好汉歌
好汉歌这首歌是从哪儿来的	MUSIC_SEARCH	TITLE:好汉歌
好的情人里面歌曲的名字都是什么	MUSIC_SEARCH	ALBUMNAME:好的情人
好胆你就来这首歌有没有吸收拉丁美洲的元素	MUSIC_SEARCH	TITLE:好胆你就来
好花不常开是不是八十年代的经典老歌	MUSIC_SEARCH	year:八十年代	GENRE:经典老歌	TITLE:好花不常开
好风长吟这首歌怎么样	MUSIC_SEARCH	TITLE:好风长吟
如今才是唯一是什么专辑里的歌	MUSIC_SEARCH	TITLE:如今才是唯一
如果云知道是作做的词	MUSIC_SEARCH	TITLE:如果云知道
姜华最新专辑是什么	MUSIC_SEARCH	ARTIST_OR_COMPOSER:姜华
姜星的那首要知道你的感觉	MUSIC_SEARCH	ARTIST_OR_COMPOSER:姜星	TITLE:要知道你的感觉
姜育恒的歌曲速度快么	MUSIC_SEARCH	ARTIST_OR_COMPOSER:姜育恒
婚礼都放什么音乐	MUSIC_SEARCH	GENRE:婚礼
嫂子颂属于什么类型的歌曲	MUSIC_SEARCH	TITLE:嫂子颂
存在的力量的歌曲是不是都是情歌	MUSIC_SEARCH	GENRE:情歌	ALBUMNAME:存在的力量
存在的力量这个专辑里的歌都是谁写的	MUSIC_SEARCH	ALBUMNAME:存在的力量
存在的力量这张专辑的发行公司是什么	MUSIC_SEARCH	ALBUMNAME:存在的力量
孙建平的那首旋木	MUSIC_SEARCH	ARTIST_OR_COMPOSER:孙建平	TITLE:旋木
孙悟空这首歌是什么分类	MUSIC_SEARCH	TITLE:孙悟空
孙晓亮的那首一起去巴黎	MUSIC_SEARCH	ARTIST_OR_COMPOSER:孙晓亮	TITLE:一起去巴黎
孙燕姿演唱过几首歌曲	MUSIC_SEARCH	ARTIST_OR_COMPOSER:孙燕姿
孟文豪的歌是不是很动听	MUSIC_SEARCH	ARTIST_OR_COMPOSER:孟文豪
孤风残影这首歌有多长	MUSIC_SEARCH	TITLE:孤风残影
学会离开的演唱家是谁	MUSIC_SEARCH	TITLE:学会离开
孩子妈是什么类型的歌	MUSIC_SEARCH	TITLE:孩子妈
孩子的眼睛的作曲家是谁	MUSIC_SEARCH	TITLE:孩子的眼睛
宅无处不在的歌曲主要是由谁演唱的	MUSIC_SEARCH	ALBUMNAME:宅无处不在
宅无处不在里面都是什么年份的歌曲	MUSIC_SEARCH	ALBUMNAME:宅无处不在
安博莉亚唱过寻找李慧珍吗	MUSIC_SEARCH	ARTIST_OR_COMPOSER:安博莉亚	TITLE:寻找李慧珍
安徒生不后悔的歌词是什么	MUSIC_SEARCH	TITLE:安徒生不后悔
宋承宪的那首烦着呢	MUSIC_SEARCH	ARTIST_OR_COMPOSER:宋承宪	TITLE:烦着呢
完全启示录这首歌怎么样啊	MUSIC_SEARCH	TITLE:完全启示录
完美的互动这首歌有没有法语版	MUSIC_SEARCH	TITLE:完美的互动
官场斗这首歌好听么	MUSIC_SEARCH	TITLE:官场斗
实情的歌曲分类是什么	MUSIC_SEARCH	TITLE:实情
害怕回家来自于哪个专辑	MUSIC_SEARCH	TITLE:害怕回家
宽恕无罪适不适合年轻人	MUSIC_SEARCH	TITLE:宽恕无罪
寂寞堂口是不是在六十年代很流行	MUSIC_SEARCH	TITLE:寂寞堂口	year:六十年代
寒命这首曲子被下载过多少次	MUSIC_SEARCH	TITLE:寒命
对不起不爱你是什么样的歌曲	MUSIC_SEARCH	TITLE:对不起不爱你
对你我永不放弃这首歌的风格是什么	MUSIC_SEARCH	TITLE:对你我永不放弃
对唱歌组	MUSIC_SEARCH	GENRE:对唱
对猪弹琴的曲子是抄的哪首歌	MUSIC_SEARCH	TITLE:对猪弹琴
寻你这个专辑怎么样	MUSIC_SEARCH	ALBUMNAME:寻你
寻找西门庆这个专辑怎么样	MUSIC_SEARCH	ALBUMNAME:寻找西门庆
寻找迈克尔这首歌好听么	MUSIC_SEARCH	TITLE:寻找迈克尔
射手的歌曲内容都是什么	MUSIC_SEARCH	ALBUMNAME:射手
将爱这个专辑如何	MUSIC_SEARCH	ALBUMNAME:将爱
小刀乐团唱了要你亲口对我说吗	MUSIC_SEARCH	ARTIST_OR_COMPOSER:小刀乐团	TITLE:要你亲口对我说
小沈阳唱过哪几首歌啊	MUSIC_SEARCH	ARTIST_OR_COMPOSER:小沈阳
小蓓蕾组合是不是很有名	MUSIC_SEARCH	ARTIST_OR_COMPOSER:小蓓蕾组合
小西康阳唱过的漂白的心	MUSIC_SEARCH	ARTIST_OR_COMPOSER:小西康阳	TITLE:漂白的心
小雨写立可白有没有被翻译到英文过	MUSIC_SEARCH	TITLE:小雨写立可白
小龙女播放列表	MUSIC_SEARCH	ARTIST_OR_COMPOSER:小龙女
少女时代唱过的爱转动	MUSIC_SEARCH	ARTIST_OR_COMPOSER:少女时代	TITLE:爱转动
展翅高飞适不适合老年人听	MUSIC_SEARCH	TITLE:展翅高飞
山野的路人	MUSIC_SEARCH	ARTIST_OR_COMPOSER:山野	TITLE:路人
左岸这首歌非常得流行么	MUSIC_SEARCH	TITLE:左岸
已经非常好是什么时候的歌	MUSIC_SEARCH	TITLE:已经非常好
希瑞克劳的感谢爱人	MUSIC_SEARCH	ARTIST_OR_COMPOSER:希瑞克劳	ALBUMNAME:感谢爱人
帕瓦罗蒂唱过哪几个歌剧	MUSIC_SEARCH	ARTIST_OR_COMPOSER:帕瓦罗蒂	GENRE:歌剧
帕瓦罗蒂最出名的歌剧是什么	MUSIC_SEARCH	ARTIST_OR_COMPOSER:帕瓦罗蒂	GENRE:歌剧
带我飞的歌词都告诉我	MUSIC_SEARCH	TITLE:带我飞
帮忙搜索七里香这个专辑	MUSIC_SEARCH	ALBUMNAME:七里香
帮忙搜索专辑不可不信缘	MUSIC_SEARCH	ALBUMNAME:不可不信缘
帮忙搜索专辑乐行者	MUSIC_SEARCH	ALBUMNAME:乐行者
帮忙搜索专辑再会了	MUSIC_SEARCH	ALBUMNAME:再会了
帮忙搜索专辑双霸	MUSIC_SEARCH	ALBUMNAME:双霸
帮忙搜索专辑只知道此刻爱你	MUSIC_SEARCH	ALBUMNAME:只知道此刻爱你
帮忙搜索专辑回到你身边	MUSIC_SEARCH	ALBUMNAME:回到你身边
帮忙搜索专辑如果你是我的传说	MUSIC_SEARCH	ALBUMNAME:如果你是我的传说
帮忙搜索专辑情感的禁区	MUSIC_SEARCH	ALBUMNAME:情感的禁区
帮忙搜索专辑曹操	MUSIC_SEARCH	ALBUMNAME:曹操
帮忙搜索专辑第二天堂	MUSIC_SEARCH	ALBUMNAME:第二天堂
帮忙搜索专辑西界	MUSIC_SEARCH	ALBUMNAME:西界
帮忙搜索专辑音乐进化全过程	MUSIC_SEARCH	ALBUMNAME:音乐进化全过程
帮忙搜索依然范特西这个专辑	MUSIC_SEARCH	ALBUMNAME:依然范特西
帮忙搜索八度空间这个专辑	MUSIC_SEARCH	ALBUMNAME:八度空间
帮忙搜索十一月的萧邦这个专辑	MUSIC_SEARCH	ALBUMNAME:十一月的萧邦
帮忙搜索叫Q版一族的专辑	MUSIC_SEARCH	ALBUMNAME:Q版一族
帮忙搜索叫五时三十分的专辑	MUSIC_SEARCH	ALBUMNAME:五时三十分
帮忙搜索叫因为爱的专辑	MUSIC_SEARCH	ALBUMNAME:因为爱
帮忙搜索叫天意的专辑	MUSIC_SEARCH	ALBUMNAME:天意
帮忙搜索叫忘情水的专辑	MUSIC_SEARCH	ALBUMNAME:忘情水
帮忙搜索叫情未了的专辑	MUSIC_SEARCH	ALBUMNAME:情未了
帮忙搜索叫来生缘的专辑	MUSIC_SEARCH	ALBUMNAME:来生缘
帮忙搜索叫爱在刻骨铭心时的专辑	MUSIC_SEARCH	ALBUMNAME:爱在刻骨铭心时
帮忙搜索叫爱的空间的专辑	MUSIC_SEARCH	ALBUMNAME:爱的空间
帮忙搜索叫真我的风采的专辑	MUSIC_SEARCH	ALBUMNAME:真我的风采
帮忙搜索叫真生命的专辑	MUSIC_SEARCH	ALBUMNAME:真生命
帮忙搜索叫谢谢你的爱的专辑	MUSIC_SEARCH	ALBUMNAME:谢谢你的爱
帮忙搜索叶惠美这个专辑	MUSIC_SEARCH	ALBUMNAME:叶惠美
帮忙搜索名为你可知道我爱谁的专辑	MUSIC_SEARCH	ALBUMNAME:你可知道我爱谁
帮忙搜索名为偿还的专辑	MUSIC_SEARCH	ALBUMNAME:偿还
帮忙搜索名为初次尝到寂寞的专辑	MUSIC_SEARCH	ALBUMNAME:初次尝到寂寞
帮忙搜索名为千言万语的专辑	MUSIC_SEARCH	ALBUMNAME:千言万语
帮忙搜索名为南海姑娘的专辑	MUSIC_SEARCH	ALBUMNAME:南海姑娘
帮忙搜索名为天国的情人的专辑	MUSIC_SEARCH	ALBUMNAME:天国的情人
帮忙搜索名为小城故事的专辑	MUSIC_SEARCH	ALBUMNAME:小城故事
帮忙搜索名为往事如昨的专辑	MUSIC_SEARCH	ALBUMNAME:往事如昨
帮忙搜索名为快乐的恰恰姑娘的专辑	MUSIC_SEARCH	ALBUMNAME:快乐的恰恰姑娘
帮忙搜索名为水上人的专辑	MUSIC_SEARCH	ALBUMNAME:水上人
帮忙搜索名为淡淡幽情的专辑	MUSIC_SEARCH	ALBUMNAME:淡淡幽情
帮忙搜索名为漫步人生路的专辑	MUSIC_SEARCH	ALBUMNAME:漫步人生路
帮忙搜索名为甜蜜蜜的专辑	MUSIC_SEARCH	ALBUMNAME:甜蜜蜜
帮忙搜索名叫一只牛的异想世界的专辑	MUSIC_SEARCH	ALBUMNAME:一只牛的异想世界
帮忙搜索名叫不了情的专辑	MUSIC_SEARCH	ALBUMNAME:不了情
帮忙搜索名叫人间爱的专辑	MUSIC_SEARCH	ALBUMNAME:人间爱
帮忙搜索名叫再说一次我爱你的专辑	MUSIC_SEARCH	ALBUMNAME:再说一次我爱你
帮忙搜索名叫别把眉儿皱的专辑	MUSIC_SEARCH	ALBUMNAME:别把眉儿皱
帮忙搜索名叫声音的专辑	MUSIC_SEARCH	ALBUMNAME:声音
帮忙搜索名叫天开了的专辑	MUSIC_SEARCH	ALBUMNAME:天开了
帮忙搜索名叫如果有一天的专辑	MUSIC_SEARCH	ALBUMNAME:如果有一天
帮忙搜索名叫妹力新世纪的专辑	MUSIC_SEARCH	ALBUMNAME:妹力新世纪
帮忙搜索名叫心蓝的专辑	MUSIC_SEARCH	ALBUMNAME:心蓝
帮忙搜索名叫爱像一首歌的专辑	MUSIC_SEARCH	ALBUMNAME:爱像一首歌
帮忙搜索名叫爱无知的专辑	MUSIC_SEARCH	ALBUMNAME:爱无知
帮忙搜索名叫美丽的一天的专辑	MUSIC_SEARCH	ALBUMNAME:美丽的一天
帮忙搜索名字叫丝路的专辑	MUSIC_SEARCH	ALBUMNAME:丝路
帮忙搜索名字叫亲亲的专辑	MUSIC_SEARCH	ALBUMNAME:亲亲
帮忙搜索名字叫今天情人节的专辑	MUSIC_SEARCH	ALBUMNAME:今天情人节
帮忙搜索名字叫完美的一天的专辑	MUSIC_SEARCH	ALBUMNAME:完美的一天
帮忙搜索名字叫崇拜的专辑	MUSIC_SEARCH	ALBUMNAME:崇拜
帮忙搜索名字叫恋爱的力量的专辑	MUSIC_SEARCH	ALBUMNAME:恋爱的力量
帮忙搜索名字叫我爱邓丽君的专辑	MUSIC_SEARCH	ALBUMNAME:我爱邓丽君
帮忙搜索名字叫我要的幸福的专辑	MUSIC_SEARCH	ALBUMNAME:我要的幸福
帮忙搜索名字叫未完成的专辑	MUSIC_SEARCH	ALBUMNAME:未完成
帮忙搜索名字叫自选辑的专辑	MUSIC_SEARCH	ALBUMNAME:自选辑
帮忙搜索名字叫逆光的专辑	MUSIC_SEARCH	ALBUMNAME:逆光
帮忙搜索名字叫风筝的专辑	MUSIC_SEARCH	ALBUMNAME:风筝
帮忙搜索名字是一个小心愿的专辑	MUSIC_SEARCH	ALBUMNAME:一个小心愿
帮忙搜索名字是一封情书的专辑	MUSIC_SEARCH	ALBUMNAME:一封情书
帮忙搜索名字是再见我的爱人的专辑	MUSIC_SEARCH	ALBUMNAME:再见我的爱人
帮忙搜索名字是原乡人的专辑	MUSIC_SEARCH	ALBUMNAME:原乡人
帮忙搜索名字是又见炊烟的专辑	MUSIC_SEARCH	ALBUMNAME:又见炊烟
帮忙搜索名字是在水一方的专辑	MUSIC_SEARCH	ALBUMNAME:在水一方
帮忙搜索名字是姐妹的专辑	MUSIC_SEARCH	ALBUMNAME:姐妹
帮忙搜索名字是小村之恋的专辑	MUSIC_SEARCH	ALBUMNAME:小村之恋
帮忙搜索名字是永恒巨星典藏版的专辑	MUSIC_SEARCH	ALBUMNAME:永恒巨星典藏版
帮忙搜索名字是牵手的专辑	MUSIC_SEARCH	ALBUMNAME:牵手
帮忙搜索名字是的专辑歌声妹影	MUSIC_SEARCH	ALBUMNAME:歌声妹影
帮忙搜索名字是艳红小曲的专辑	MUSIC_SEARCH	ALBUMNAME:艳红小曲
帮忙搜索唯舞独尊这个专辑	MUSIC_SEARCH	ALBUMNAME:唯舞独尊
帮忙搜索城堡这个专辑	MUSIC_SEARCH	ALBUMNAME:城堡
帮忙搜索爱的练习语这个专辑	MUSIC_SEARCH	ALBUMNAME:爱的练习语
帮忙搜索看我72变这个专辑	MUSIC_SEARCH	ALBUMNAME:看我72变
帮忙搜索舞娘这个专辑	MUSIC_SEARCH	ALBUMNAME:舞娘
帮忙搜索花蝴蝶这个专辑	MUSIC_SEARCH	ALBUMNAME:花蝴蝶
帮忙搜索范特西这个专辑	MUSIC_SEARCH	ALBUMNAME:范特西
帮忙搜索跨时代这个专辑	MUSIC_SEARCH	ALBUMNAME:跨时代
帮忙搜索魔杰座这个专辑	MUSIC_SEARCH	ALBUMNAME:魔杰座
帮忙查找专辑一起长大	MUSIC_SEARCH	ALBUMNAME:一起长大
帮忙查找专辑三天三夜	MUSIC_SEARCH	ALBUMNAME:三天三夜
帮忙查找专辑亲爱的理由	MUSIC_SEARCH	ALBUMNAME:亲爱的理由
帮忙查找专辑傻瓜探戈	MUSIC_SEARCH	ALBUMNAME:傻瓜探戈
帮忙查找专辑再见你好吗	MUSIC_SEARCH	ALBUMNAME:再见你好吗
帮忙查找专辑天蓝如海	MUSIC_SEARCH	ALBUMNAME:天蓝如海
帮忙查找专辑我们	MUSIC_SEARCH	ALBUMNAME:我们
帮忙查找专辑我知道你离我不远	MUSIC_SEARCH	ALBUMNAME:我知道你离我不远
帮忙查找专辑桐花	MUSIC_SEARCH	ALBUMNAME:桐花
帮忙查找专辑盛开	MUSIC_SEARCH	ALBUMNAME:盛开
帮忙查找专辑看海	MUSIC_SEARCH	ALBUMNAME:看海
帮忙查找专辑谢幕	MUSIC_SEARCH	ALBUMNAME:谢幕
帮忙查找专辑青春	MUSIC_SEARCH	ALBUMNAME:青春
帮忙查找专辑青春再见	MUSIC_SEARCH	ALBUMNAME:青春再见
帮忙查找乐之路这个专辑	MUSIC_SEARCH	ALBUMNAME:乐之路
帮忙查找何必再拖这个专辑	MUSIC_SEARCH	ALBUMNAME:何必再拖
帮忙查找叫一夜长大的专辑	MUSIC_SEARCH	ALBUMNAME:一夜长大
帮忙查找叫一肩之隔的专辑	MUSIC_SEARCH	ALBUMNAME:一肩之隔
帮忙查找叫一首心歌的专辑	MUSIC_SEARCH	ALBUMNAME:一首心歌
帮忙查找叫伤心的女人怎么了的专辑	MUSIC_SEARCH	ALBUMNAME:伤心的女人怎么了
帮忙查找叫勇气的专辑	MUSIC_SEARCH	ALBUMNAME:勇气
帮忙查找叫捍卫阳光的专辑	MUSIC_SEARCH	ALBUMNAME:捍卫阳光
帮忙查找叫漂的专辑	MUSIC_SEARCH	ALBUMNAME:漂
帮忙查找叫爱爱爱爱的专辑	MUSIC_SEARCH	ALBUMNAME:爱爱爱爱
帮忙查找叫爱过那张脸的专辑	MUSIC_SEARCH	ALBUMNAME:爱过那张脸
帮忙查找叫的专辑时间煮雨	MUSIC_SEARCH	ALBUMNAME:时间煮雨
帮忙查找叫美丽人生的专辑	MUSIC_SEARCH	ALBUMNAME:美丽人生
帮忙查找叫走进你的梦的专辑	MUSIC_SEARCH	ALBUMNAME:走进你的梦
帮忙查找叫闪亮的星的专辑	MUSIC_SEARCH	ALBUMNAME:闪亮的星
帮忙查找名叫三的专辑	MUSIC_SEARCH	ALBUMNAME:三
帮忙查找名叫世界看我的专辑	MUSIC_SEARCH	ALBUMNAME:世界看我
帮忙查找名叫会飞的贼的专辑	MUSIC_SEARCH	ALBUMNAME:会飞的贼
帮忙查找名叫光阴的故事 的专辑	MUSIC_SEARCH	ALBUMNAME:光阴的故事
帮忙查找名叫情话的专辑	MUSIC_SEARCH	ALBUMNAME:情话
帮忙查找名叫放心不下的专辑	MUSIC_SEARCH	ALBUMNAME:放心不下
帮忙查找名叫枪神的荣耀的专辑	MUSIC_SEARCH	ALBUMNAME:枪神的荣耀
帮忙查找名叫漫游的专辑	MUSIC_SEARCH	ALBUMNAME:漫游
帮忙查找名叫美好的专辑	MUSIC_SEARCH	ALBUMNAME:美好
帮忙查找名叫能不能的专辑	MUSIC_SEARCH	ALBUMNAME:能不能
帮忙查找名叫致青春的专辑	MUSIC_SEARCH	ALBUMNAME:致青春
帮忙查找名叫陪我去流浪的专辑	MUSIC_SEARCH	ALBUMNAME:陪我去流浪
帮忙查找名叫黄河长江的专辑	MUSIC_SEARCH	ALBUMNAME:黄河长江
帮忙查找名字叫下一个天亮的专辑	MUSIC_SEARCH	ALBUMNAME:下一个天亮
帮忙查找名字叫不想懂得的专辑	MUSIC_SEARCH	ALBUMNAME:不想懂得
帮忙查找名字叫华丽的冒险的专辑	MUSIC_SEARCH	ALBUMNAME:华丽的冒险
帮忙查找名字叫在树上唱歌的专辑	MUSIC_SEARCH	ALBUMNAME:在树上唱歌
帮忙查找名字叫太阳的专辑	MUSIC_SEARCH	ALBUMNAME:太阳
帮忙查找名字叫小宇宙的专辑	MUSIC_SEARCH	ALBUMNAME:小宇宙
帮忙查找名字叫我不想忘记你的专辑	MUSIC_SEARCH	ALBUMNAME:我不想忘记你
帮忙查找名字叫我的未来不是梦的专辑	MUSIC_SEARCH	ALBUMNAME:我的未来不是梦
帮忙查找名字叫无与伦比的美丽的专辑	MUSIC_SEARCH	ALBUMNAME:无与伦比的美丽
帮忙查找名字叫独一无二的专辑	MUSIC_SEARCH	ALBUMNAME:独一无二
帮忙查找名字叫苏打绿的专辑	MUSIC_SEARCH	ALBUMNAME:苏打绿
帮忙查找名字叫让我想一想的专辑	MUSIC_SEARCH	ALBUMNAME:让我想一想
帮忙查找名字叫还是会寂寞的专辑	MUSIC_SEARCH	ALBUMNAME:还是会寂寞
帮忙查找名字叫迟到千年的专辑	MUSIC_SEARCH	ALBUMNAME:迟到千年
帮忙查找天天有喜这个专辑	MUSIC_SEARCH	ALBUMNAME:天天有喜
帮忙查找太平盛世这个专辑	MUSIC_SEARCH	ALBUMNAME:太平盛世
帮忙查找太美丽这个专辑	MUSIC_SEARCH	ALBUMNAME:太美丽
帮忙查找好想你这个专辑	MUSIC_SEARCH	ALBUMNAME:好想你
帮忙查找我是海棠这个专辑	MUSIC_SEARCH	ALBUMNAME:我是海棠
帮忙查找我是海雅谷慕这个专辑	MUSIC_SEARCH	ALBUMNAME:我是海雅谷慕
帮忙查找拾伍这个专辑	MUSIC_SEARCH	ALBUMNAME:拾伍
帮忙查找爱的筹码这个专辑	MUSIC_SEARCH	ALBUMNAME:爱的筹码
帮忙查找这宅无处不在 个专辑	MUSIC_SEARCH	ALBUMNAME:宅无处不在
帮忙查找音乐新浪潮这个专辑	MUSIC_SEARCH	ALBUMNAME:音乐新浪潮
帮忙查找黑色橙子这个专辑	MUSIC_SEARCH	ALBUMNAME:黑色橙子
帮我搜索七里香这个专辑	MUSIC_SEARCH	ALBUMNAME:七里香
帮我搜索专辑不可不信缘	MUSIC_SEARCH	ALBUMNAME:不可不信缘
帮我搜索专辑乐行者	MUSIC_SEARCH	ALBUMNAME:乐行者
帮我搜索专辑再会了	MUSIC_SEARCH	ALBUMNAME:再会了
帮我搜索专辑双霸	MUSIC_SEARCH	ALBUMNAME:双霸
帮我搜索专辑只知道此刻爱你	MUSIC_SEARCH	ALBUMNAME:只知道此刻爱你
帮我搜索专辑回到你身边	MUSIC_SEARCH	ALBUMNAME:回到你身边
帮我搜索专辑如果你是我的传说	MUSIC_SEARCH	ALBUMNAME:如果你是我的传说
帮我搜索专辑情感的禁区	MUSIC_SEARCH	ALBUMNAME:情感的禁区
帮我搜索专辑曹操	MUSIC_SEARCH	ALBUMNAME:曹操
帮我搜索专辑第二天堂	MUSIC_SEARCH	ALBUMNAME:第二天堂
帮我搜索专辑西界	MUSIC_SEARCH	ALBUMNAME:西界
帮我搜索专辑音乐进化全过程	MUSIC_SEARCH	ALBUMNAME:音乐进化全过程
帮我搜索依然范特西这个专辑	MUSIC_SEARCH	ALBUMNAME:依然范特西
帮我搜索八度空间这个专辑	MUSIC_SEARCH	ALBUMNAME:八度空间
帮我搜索十一月的萧邦这个专辑	MUSIC_SEARCH	ALBUMNAME:十一月的萧邦
帮我搜索叫Q版一族的专辑	MUSIC_SEARCH	ALBUMNAME:Q版一族
帮我搜索叫五时三十分的专辑	MUSIC_SEARCH	ALBUMNAME:五时三十分
帮我搜索叫因为爱的专辑	MUSIC_SEARCH	ALBUMNAME:因为爱
帮我搜索叫天意的专辑	MUSIC_SEARCH	ALBUMNAME:天意
帮我搜索叫忘情水的专辑	MUSIC_SEARCH	ALBUMNAME:忘情水
帮我搜索叫情未了的专辑	MUSIC_SEARCH	ALBUMNAME:情未了
帮我搜索叫来生缘的专辑	MUSIC_SEARCH	ALBUMNAME:来生缘
帮我搜索叫爱在刻骨铭心时的专辑	MUSIC_SEARCH	ALBUMNAME:爱在刻骨铭心时
帮我搜索叫爱的空间的专辑	MUSIC_SEARCH	ALBUMNAME:爱的空间
帮我搜索叫真我的风采的专辑	MUSIC_SEARCH	ALBUMNAME:真我的风采
帮我搜索叫真生命的专辑	MUSIC_SEARCH	ALBUMNAME:真生命
帮我搜索叫谢谢你的爱的专辑	MUSIC_SEARCH	ALBUMNAME:谢谢你的爱
帮我搜索叶惠美这个专辑	MUSIC_SEARCH	ALBUMNAME:叶惠美
帮我搜索名为你可知道我爱谁的专辑	MUSIC_SEARCH	ALBUMNAME:你可知道我爱谁
帮我搜索名为偿还的专辑	MUSIC_SEARCH	ALBUMNAME:偿还
帮我搜索名为初次尝到寂寞的专辑	MUSIC_SEARCH	ALBUMNAME:初次尝到寂寞
帮我搜索名为千言万语的专辑	MUSIC_SEARCH	ALBUMNAME:千言万语
帮我搜索名为南海姑娘的专辑	MUSIC_SEARCH	ALBUMNAME:南海姑娘
帮我搜索名为天国的情人的专辑	MUSIC_SEARCH	ALBUMNAME:天国的情人
帮我搜索名为小城故事的专辑	MUSIC_SEARCH	ALBUMNAME:小城故事
帮我搜索名为往事如昨的专辑	MUSIC_SEARCH	ALBUMNAME:往事如昨
帮我搜索名为快乐的恰恰姑娘的专辑	MUSIC_SEARCH	ALBUMNAME:快乐的恰恰姑娘
帮我搜索名为水上人的专辑	MUSIC_SEARCH	ALBUMNAME:水上人
帮我搜索名为淡淡幽情的专辑	MUSIC_SEARCH	ALBUMNAME:淡淡幽情
帮我搜索名为漫步人生路的专辑	MUSIC_SEARCH	ALBUMNAME:漫步人生路
帮我搜索名为甜蜜蜜的专辑	MUSIC_SEARCH	ALBUMNAME:甜蜜蜜
帮我搜索名叫一只牛的异想世界的专辑	MUSIC_SEARCH	ALBUMNAME:一只牛的异想世界
帮我搜索名叫不了情的专辑	MUSIC_SEARCH	ALBUMNAME:不了情
帮我搜索名叫人间爱的专辑	MUSIC_SEARCH	ALBUMNAME:人间爱
帮我搜索名叫再说一次我爱你的专辑	MUSIC_SEARCH	ALBUMNAME:再说一次我爱你
帮我搜索名叫别把眉儿皱的专辑	MUSIC_SEARCH	ALBUMNAME:别把眉儿皱
帮我搜索名叫声音的专辑	MUSIC_SEARCH	ALBUMNAME:声音
帮我搜索名叫天开了的专辑	MUSIC_SEARCH	ALBUMNAME:天开了
帮我搜索名叫如果有一天的专辑	MUSIC_SEARCH	ALBUMNAME:如果有一天
帮我搜索名叫妹力新世纪的专辑	MUSIC_SEARCH	ALBUMNAME:妹力新世纪
帮我搜索名叫心蓝的专辑	MUSIC_SEARCH	ALBUMNAME:心蓝
帮我搜索名叫爱像一首歌的专辑	MUSIC_SEARCH	ALBUMNAME:爱像一首歌
帮我搜索名叫爱无知的专辑	MUSIC_SEARCH	ALBUMNAME:爱无知
帮我搜索名叫美丽的一天的专辑	MUSIC_SEARCH	ALBUMNAME:美丽的一天
帮我搜索名字叫丝路的专辑	MUSIC_SEARCH	ALBUMNAME:丝路
帮我搜索名字叫亲亲的专辑	MUSIC_SEARCH	ALBUMNAME:亲亲
帮我搜索名字叫今天情人节的专辑	MUSIC_SEARCH	ALBUMNAME:今天情人节
帮我搜索名字叫完美的一天的专辑	MUSIC_SEARCH	ALBUMNAME:完美的一天
帮我搜索名字叫崇拜的专辑	MUSIC_SEARCH	ALBUMNAME:崇拜
帮我搜索名字叫恋爱的力量的专辑	MUSIC_SEARCH	ALBUMNAME:恋爱的力量
帮我搜索名字叫我爱邓丽君的专辑	MUSIC_SEARCH	ALBUMNAME:我爱邓丽君
帮我搜索名字叫我要的幸福的专辑	MUSIC_SEARCH	ALBUMNAME:我要的幸福
帮我搜索名字叫未完成的专辑	MUSIC_SEARCH	ALBUMNAME:未完成
帮我搜索名字叫自选辑的专辑	MUSIC_SEARCH	ALBUMNAME:自选辑
帮我搜索名字叫逆光的专辑	MUSIC_SEARCH	ALBUMNAME:逆光
帮我搜索名字叫风筝的专辑	MUSIC_SEARCH	ALBUMNAME:风筝
帮我搜索名字是一个小心愿的专辑	MUSIC_SEARCH	ALBUMNAME:一个小心愿
帮我搜索名字是一封情书的专辑	MUSIC_SEARCH	ALBUMNAME:一封情书
帮我搜索名字是再见我的爱人的专辑	MUSIC_SEARCH	ALBUMNAME:再见我的爱人
帮我搜索名字是原乡人的专辑	MUSIC_SEARCH	ALBUMNAME:原乡人
帮我搜索名字是又见炊烟的专辑	MUSIC_SEARCH	ALBUMNAME:又见炊烟
帮我搜索名字是在水一方的专辑	MUSIC_SEARCH	ALBUMNAME:在水一方
帮我搜索名字是姐妹的专辑	MUSIC_SEARCH	ALBUMNAME:姐妹
帮我搜索名字是小村之恋的专辑	MUSIC_SEARCH	ALBUMNAME:小村之恋
帮我搜索名字是永恒巨星典藏版的专辑	MUSIC_SEARCH	ALBUMNAME:永恒巨星典藏版
帮我搜索名字是牵手的专辑	MUSIC_SEARCH	ALBUMNAME:牵手
帮我搜索名字是的专辑歌声妹影	MUSIC_SEARCH	ALBUMNAME:歌声妹影
帮我搜索名字是艳红小曲的专辑	MUSIC_SEARCH	ALBUMNAME:艳红小曲
帮我搜索唯舞独尊这个专辑	MUSIC_SEARCH	ALBUMNAME:唯舞独尊
帮我搜索城堡这个专辑	MUSIC_SEARCH	ALBUMNAME:城堡
帮我搜索爱的练习语这个专辑	MUSIC_SEARCH	ALBUMNAME:爱的练习语
帮我搜索看我72变这个专辑	MUSIC_SEARCH	ALBUMNAME:看我72变
帮我搜索舞娘这个专辑	MUSIC_SEARCH	ALBUMNAME:舞娘
帮我搜索花蝴蝶这个专辑	MUSIC_SEARCH	ALBUMNAME:花蝴蝶
帮我搜索范特西这个专辑	MUSIC_SEARCH	ALBUMNAME:范特西
帮我搜索跨时代这个专辑	MUSIC_SEARCH	ALBUMNAME:跨时代
帮我搜索邓丽君的歌曲	MUSIC_SEARCH	ARTIST_OR_COMPOSER:邓丽君
帮我搜索魔杰座这个专辑	MUSIC_SEARCH	ALBUMNAME:魔杰座
帮我查找专辑一起长大	MUSIC_SEARCH	ALBUMNAME:一起长大
帮我查找专辑三天三夜	MUSIC_SEARCH	ALBUMNAME:三天三夜
帮我查找专辑亲爱的理由	MUSIC_SEARCH	ALBUMNAME:亲爱的理由
帮我查找专辑傻瓜探戈	MUSIC_SEARCH	ALBUMNAME:傻瓜探戈
帮我查找专辑再见你好吗	MUSIC_SEARCH	ALBUMNAME:再见你好吗
帮我查找专辑天蓝如海	MUSIC_SEARCH	ALBUMNAME:天蓝如海
帮我查找专辑我们	MUSIC_SEARCH	ALBUMNAME:我们
帮我查找专辑我知道你离我不远	MUSIC_SEARCH	ALBUMNAME:我知道你离我不远
帮我查找专辑桐花	MUSIC_SEARCH	ALBUMNAME:桐花
帮我查找专辑盛开	MUSIC_SEARCH	ALBUMNAME:盛开
帮我查找专辑看海	MUSIC_SEARCH	ALBUMNAME:看海
帮我查找专辑谢幕	MUSIC_SEARCH	ALBUMNAME:谢幕
帮我查找专辑青春	MUSIC_SEARCH	ALBUMNAME:青春
帮我查找专辑青春再见	MUSIC_SEARCH	ALBUMNAME:青春再见
帮我查找乐之路这个专辑	MUSIC_SEARCH	ALBUMNAME:乐之路
帮我查找何必再拖这个专辑	MUSIC_SEARCH	ALBUMNAME:何必再拖
帮我查找叫一夜长大的专辑	MUSIC_SEARCH	ALBUMNAME:一夜长大
帮我查找叫一肩之隔的专辑	MUSIC_SEARCH	ALBUMNAME:一肩之隔
帮我查找叫一首心歌的专辑	MUSIC_SEARCH	ALBUMNAME:一首心歌
帮我查找叫伤心的女人怎么了的专辑	MUSIC_SEARCH	ALBUMNAME:伤心的女人怎么了
帮我查找叫勇气的专辑	MUSIC_SEARCH	ALBUMNAME:勇气
帮我查找叫捍卫阳光的专辑	MUSIC_SEARCH	ALBUMNAME:捍卫阳光
帮我查找叫漂的专辑	MUSIC_SEARCH	ALBUMNAME:漂
帮我查找叫爱爱爱爱的专辑	MUSIC_SEARCH	ALBUMNAME:爱爱爱爱
帮我查找叫爱过那张脸的专辑	MUSIC_SEARCH	ALBUMNAME:爱过那张脸
帮我查找叫的专辑时间煮雨	MUSIC_SEARCH	ALBUMNAME:时间煮雨
帮我查找叫美丽人生的专辑	MUSIC_SEARCH	ALBUMNAME:美丽人生
帮我查找叫走进你的梦的专辑	MUSIC_SEARCH	ALBUMNAME:走进你的梦
帮我查找叫闪亮的星的专辑	MUSIC_SEARCH	ALBUMNAME:闪亮的星
帮我查找名叫三的专辑	MUSIC_SEARCH	ALBUMNAME:三
帮我查找名叫世界看我的专辑	MUSIC_SEARCH	ALBUMNAME:世界看我
帮我查找名叫会飞的贼的专辑	MUSIC_SEARCH	ALBUMNAME:会飞的贼
帮我查找名叫光阴的故事 的专辑	MUSIC_SEARCH	ALBUMNAME:光阴的故事
帮我查找名叫情话的专辑	MUSIC_SEARCH	ALBUMNAME:情话
帮我查找名叫放心不下的专辑	MUSIC_SEARCH	ALBUMNAME:放心不下
帮我查找名叫枪神的荣耀的专辑	MUSIC_SEARCH	ALBUMNAME:枪神的荣耀
帮我查找名叫漫游的专辑	MUSIC_SEARCH	ALBUMNAME:漫游
帮我查找名叫美好的专辑	MUSIC_SEARCH	ALBUMNAME:美好
帮我查找名叫能不能的专辑	MUSIC_SEARCH	ALBUMNAME:能不能
帮我查找名叫致青春的专辑	MUSIC_SEARCH	ALBUMNAME:致青春
帮我查找名叫陪我去流浪的专辑	MUSIC_SEARCH	ALBUMNAME:陪我去流浪
帮我查找名叫黄河长江的专辑	MUSIC_SEARCH	ALBUMNAME:黄河长江
帮我查找名字叫下一个天亮的专辑	MUSIC_SEARCH	ALBUMNAME:下一个天亮
帮我查找名字叫不想懂得的专辑	MUSIC_SEARCH	ALBUMNAME:不想懂得
帮我查找名字叫华丽的冒险的专辑	MUSIC_SEARCH	ALBUMNAME:华丽的冒险
帮我查找名字叫在树上唱歌的专辑	MUSIC_SEARCH	ALBUMNAME:在树上唱歌
帮我查找名字叫太阳的专辑	MUSIC_SEARCH	ALBUMNAME:太阳
帮我查找名字叫小宇宙的专辑	MUSIC_SEARCH	ALBUMNAME:小宇宙
帮我查找名字叫我不想忘记你的专辑	MUSIC_SEARCH	ALBUMNAME:我不想忘记你
帮我查找名字叫我的未来不是梦的专辑	MUSIC_SEARCH	ALBUMNAME:我的未来不是梦
帮我查找名字叫无与伦比的美丽的专辑	MUSIC_SEARCH	ALBUMNAME:无与伦比的美丽
帮我查找名字叫独一无二的专辑	MUSIC_SEARCH	ALBUMNAME:独一无二
帮我查找名字叫苏打绿的专辑	MUSIC_SEARCH	ALBUMNAME:苏打绿
帮我查找名字叫让我想一想的专辑	MUSIC_SEARCH	ALBUMNAME:让我想一想
帮我查找名字叫还是会寂寞的专辑	MUSIC_SEARCH	ALBUMNAME:还是会寂寞
帮我查找名字叫迟到千年的专辑	MUSIC_SEARCH	ALBUMNAME:迟到千年
帮我查找天天有喜这个专辑	MUSIC_SEARCH	ALBUMNAME:天天有喜
帮我查找太平盛世这个专辑	MUSIC_SEARCH	ALBUMNAME:太平盛世
帮我查找太美丽这个专辑	MUSIC_SEARCH	ALBUMNAME:太美丽
帮我查找好想你这个专辑	MUSIC_SEARCH	ALBUMNAME:好想你
帮我查找我是海棠这个专辑	MUSIC_SEARCH	ALBUMNAME:我是海棠
帮我查找我是海雅谷慕这个专辑	MUSIC_SEARCH	ALBUMNAME:我是海雅谷慕
帮我查找拾伍这个专辑	MUSIC_SEARCH	ALBUMNAME:拾伍
帮我查找爱的筹码这个专辑	MUSIC_SEARCH	ALBUMNAME:爱的筹码
帮我查找这宅无处不在 个专辑	MUSIC_SEARCH	ALBUMNAME:宅无处不在
帮我查找音乐新浪潮这个专辑	MUSIC_SEARCH	ALBUMNAME:音乐新浪潮
帮我查找黑色橙子这个专辑	MUSIC_SEARCH	ALBUMNAME:黑色橙子
常在我心中这首歌的音乐好听么	MUSIC_SEARCH	TITLE:常在我心中
常安的布达拉	MUSIC_SEARCH	ARTIST_OR_COMPOSER:常安	TITLE:布达拉
并不的作词家是谁	MUSIC_SEARCH	TITLE:并不
幸福一秒吧这首歌在什么分类里	MUSIC_SEARCH	TITLE:幸福一秒吧
幸福了然后呢是什么时候发行的	MUSIC_SEARCH	ALBUMNAME:幸福了然后呢
幸福号列车这首歌比较好听么	MUSIC_SEARCH	TITLE:幸福号列车
幸福大街最新专辑是什么	MUSIC_SEARCH	ARTIST_OR_COMPOSER:幸福大街
幸福来敲门是哪个著名作词家写的	MUSIC_SEARCH	TITLE:幸福来敲门
幸福选择题什么时候发行	MUSIC_SEARCH	ALBUMNAME:幸福选择题
幸福选择题属于哪种类型的音乐	MUSIC_SEARCH	ALBUMNAME:幸福选择题
幸福选择题这个专辑属于谁	MUSIC_SEARCH	ALBUMNAME:幸福选择题
幸福选择题这张专辑是什么时候发行的	MUSIC_SEARCH	ALBUMNAME:幸福选择题
幸福选择题里面的歌有名么	MUSIC_SEARCH	ALBUMNAME:幸福选择题
幸福选择题里面都是那个年代的歌	MUSIC_SEARCH	ALBUMNAME:幸福选择题
幽兰操这个专辑如何	MUSIC_SEARCH	ALBUMNAME:幽兰操
广州爱情故事来自于哪个专辑	MUSIC_SEARCH	TITLE:广州爱情故事
底里唱的召唤	MUSIC_SEARCH	ARTIST_OR_COMPOSER:底里	TITLE:召唤
庞龙的歌曲是不是都很慢	MUSIC_SEARCH	ARTIST_OR_COMPOSER:庞龙
廖伟力唱过现在的他对你好吗吗	MUSIC_SEARCH	ARTIST_OR_COMPOSER:廖伟力	TITLE:现在的他对你好吗
廖佩伶唱过第一次为你喝醉吗	MUSIC_SEARCH	ARTIST_OR_COMPOSER:廖佩伶	TITLE:第一次为你喝醉
开到荼蘼的歌曲分类是什么	MUSIC_SEARCH	TITLE:开到荼蘼
开始链接吧这首歌有多长	MUSIC_SEARCH	TITLE:开始链接吧
开始飞吧的作曲灵感来源于什么	MUSIC_SEARCH	TITLE:开始飞吧
张伯宏的和寂寞说分手	MUSIC_SEARCH	ARTIST_OR_COMPOSER:张伯宏	TITLE:和寂寞说分手
张含韵这个专辑怎么样	MUSIC_SEARCH	ALBUMNAME:张含韵
张宇查过过什么歌曲	MUSIC_SEARCH	ARTIST_OR_COMPOSER:张宇
张惠妹有几个专辑	MUSIC_SEARCH	ARTIST_OR_COMPOSER:张惠妹
张杰唱多几首歌	MUSIC_SEARCH	ARTIST_OR_COMPOSER:张杰
张殿菲唱过另一种平静吗	MUSIC_SEARCH	ARTIST_OR_COMPOSER:张殿菲	TITLE:另一种平静
张殿菲歌组	MUSIC_SEARCH	ARTIST_OR_COMPOSER:张殿菲
张清芳最新专辑是什么	MUSIC_SEARCH	ARTIST_OR_COMPOSER:张清芳
张维良新专辑	MUSIC_SEARCH	ARTIST_OR_COMPOSER:张维良
张蔷的当年情	MUSIC_SEARCH	ARTIST_OR_COMPOSER:张蔷	TITLE:当年情
张虎专辑的信息	MUSIC_SEARCH	ARTIST_OR_COMPOSER:张虎
张觉隆唱过的因为是你	MUSIC_SEARCH	ARTIST_OR_COMPOSER:张觉隆	TITLE:因为是你
强辩乐团最新专辑是什么	MUSIC_SEARCH	ARTIST_OR_COMPOSER:强辩乐团
强麦伦坎专辑的信息	MUSIC_SEARCH	ARTIST_OR_COMPOSER:强麦伦坎
归的作词家叫什么名字	MUSIC_SEARCH	TITLE:归
当初我怎么会不懂在哪个专辑里	MUSIC_SEARCH	TITLE:当初我怎么会不懂
当年情这首歌是乡村音乐么	MUSIC_SEARCH	GENRE:乡村音乐	TITLE:当年情
当我想你的时候这首歌是谁唱的	MUSIC_SEARCH	TITLE:当我想你的时候
彭芳新专辑	MUSIC_SEARCH	ARTIST_OR_COMPOSER:彭芳
徐亮的歌曲都好听么	MUSIC_SEARCH	ARTIST_OR_COMPOSER:徐亮
徐伟贤唱过的陪你一起老	MUSIC_SEARCH	ARTIST_OR_COMPOSER:徐伟贤	TITLE:陪你一起老
徐嘉良唱过的快乐天使	MUSIC_SEARCH	ARTIST_OR_COMPOSER:徐嘉良	TITLE:快乐天使
徐若瑄唱的给我感觉	MUSIC_SEARCH	ARTIST_OR_COMPOSER:徐若瑄	TITLE:给我感觉
得到你的人却得不到你的心是不是周杰伦唱过的	MUSIC_SEARCH	ARTIST_OR_COMPOSER:周杰伦	TITLE:得到你的人却得不到你的心
得民心者的天下这首歌怎么样	MUSIC_SEARCH	TITLE:得民心者的天下
德语歌曲歌组	MUSIC_SEARCH	GENRE:德语歌曲
心中的恋人是一首新歌么	MUSIC_SEARCH	TITLE:心中的恋人
心型圈现在有多流行	MUSIC_SEARCH	TITLE:心型圈
心灵的感应是哪个电视剧的片头曲	MUSIC_SEARCH	TITLE:心灵的感应
心痛现在有多流行	MUSIC_SEARCH	TITLE:心痛
忐忑这首歌好听么	MUSIC_SEARCH	TITLE:忐忑
忘不记属于哪种类型的音乐	MUSIC_SEARCH	ALBUMNAME:忘不记
忘不记这个专辑出自哪个年代	MUSIC_SEARCH	ALBUMNAME:忘不记
忘了忧伤的作词家是谁	MUSIC_SEARCH	TITLE:忘了忧伤
忘情是什么样的歌曲	MUSIC_SEARCH	TITLE:忘情
快乐是自找的在哪个专辑里	MUSIC_SEARCH	TITLE:快乐是自找的
怎么开始这首歌流行么	MUSIC_SEARCH	TITLE:怎么开始
怎么样啊张信哲的歌	MUSIC_SEARCH	ARTIST_OR_COMPOSER:张信哲
思念是一种惩罚是个什么类的歌曲	MUSIC_SEARCH	TITLE:思念是一种惩罚
恋上你的床是什么类型的歌	MUSIC_SEARCH	TITLE:恋上你的床
恋天是什么风格的歌曲	MUSIC_SEARCH	TITLE:恋天
恋恋同学情是不是比较好听	MUSIC_SEARCH	TITLE:恋恋同学情
恨透爱情恨透你的歌曲分类是什么	MUSIC_SEARCH	TITLE:恨透爱情恨透你
悄悄话是哪个电视剧的片尾曲	MUSIC_SEARCH	TITLE:悄悄话
悲智双运这个专辑如何	MUSIC_SEARCH	ALBUMNAME:悲智双运
情人节的秘密现在还流行吗	MUSIC_SEARCH	TITLE:情人节的秘密
情人裳是什么乐团的	MUSIC_SEARCH	TITLE:情人裳
情报属于几十年代的歌曲	MUSIC_SEARCH	TITLE:情报
情火是谁演唱的	MUSIC_SEARCH	TITLE:情火
情菲得意这个专辑如何	MUSIC_SEARCH	ALBUMNAME:情菲得意
惊叫基督的专辑列表	MUSIC_SEARCH	ARTIST_OR_COMPOSER:惊叫基督
惊叹号是谁发行的专辑	MUSIC_SEARCH	ALBUMNAME:惊叹号
惊叹号的歌曲是不是都是情歌	MUSIC_SEARCH	GENRE:情歌	ALBUMNAME:惊叹号
惊叹号这个唱片最近很火么	MUSIC_SEARCH	ALBUMNAME:惊叹号
想你的距离这个专辑里是不是有十首歌	MUSIC_SEARCH	ALBUMNAME:想你的距离
想你的距离这张专辑最近很火么	MUSIC_SEARCH	ALBUMNAME:想你的距离
想你的距离里面有哪几首歌	MUSIC_SEARCH	ALBUMNAME:想你的距离
想你零点零一分是哪个专辑里的歌	MUSIC_SEARCH	TITLE:想你零点零一分
想当初的歌曲分类是什么	MUSIC_SEARCH	TITLE:想当初
想得太远是不是在世界各地都流行的歌曲	MUSIC_SEARCH	TITLE:想得太远
意大利国歌是哪个歌手专属的歌么	MUSIC_SEARCH	TITLE:意大利国歌
意大利语歌曲查找	MUSIC_SEARCH	GENRE:意大利语歌曲
意料之外是哪个国家的歌曲	MUSIC_SEARCH	TITLE:意料之外
愚蠢的爱是不是个流行音乐	MUSIC_SEARCH	GENRE:流行音乐	TITLE:愚蠢的爱
感情副作用这首歌是从哪儿来的	MUSIC_SEARCH	TITLE:感情副作用
感觉的专辑是什么时候发行的	MUSIC_SEARCH	TITLE:感觉
感谢爱人属于什么类型的音乐	MUSIC_SEARCH	ALBUMNAME:感谢爱人
感谢爱人这张专辑几月几号发行的	MUSIC_SEARCH	ALBUMNAME:感谢爱人
感谢爱人这张专辑的发行公司是什么	MUSIC_SEARCH	ALBUMNAME:感谢爱人
愿你来看我这首歌谁演唱过	MUSIC_SEARCH	TITLE:愿你来看我
慕容萱唱的你等我	MUSIC_SEARCH	ARTIST_OR_COMPOSER:慕容萱	TITLE:你等我
成长的岁月这首歌是什么时候演出的	MUSIC_SEARCH	TITLE:成长的岁月
成龙的歌	MUSIC_SEARCH	ARTIST_OR_COMPOSER:成龙
成龙的歌曲	MUSIC_SEARCH	ARTIST_OR_COMPOSER:成龙
我不像我的作曲家叫什么名字	MUSIC_SEARCH	TITLE:我不像我
我不是美女这首歌很有名么	MUSIC_SEARCH	TITLE:我不是美女
我不知道你不懂有没有被翻译到英文过	MUSIC_SEARCH	TITLE:我不知道你不懂
我不觉得这首歌是什么分类	MUSIC_SEARCH	TITLE:我不觉得
我为何让你走是作做的词	MUSIC_SEARCH	TITLE:我为何让你走
我什么时候可以买到乐曲专辑光芒	MUSIC_SEARCH	ALBUMNAME:光芒
我什么时候可以买到乐曲专辑回忆里的疯狂	MUSIC_SEARCH	ALBUMNAME:回忆里的疯狂
我什么时候可以买到乐曲专辑生无所求	MUSIC_SEARCH	ALBUMNAME:生无所求
我什么时候可以买到乐曲专辑青春	MUSIC_SEARCH	ALBUMNAME:青春
我什么时候才能买到三天三夜这个专辑	MUSIC_SEARCH	ALBUMNAME:三天三夜
我什么时候才能买到摇滚吧情歌这个专辑	MUSIC_SEARCH	ALBUMNAME:摇滚吧情歌
我什么时候才能买到海阔天空这个专辑	MUSIC_SEARCH	ALBUMNAME:海阔天空
我什么时候才能买到跳针舞曲这个专辑	MUSIC_SEARCH	ALBUMNAME:跳针舞曲
我们不再拥抱是一首情歌么	MUSIC_SEARCH	GENRE:情歌	TITLE:我们不再拥抱
我们之间的事的歌曲分类是什么	MUSIC_SEARCH	TITLE:我们之间的事
我们是阿尔法音乐制作的么	MUSIC_SEARCH	ALBUMNAME:我们
我们这个专辑里是不是有十首歌	MUSIC_SEARCH	ALBUMNAME:我们
我们这张专辑几月几号发行的	MUSIC_SEARCH	ALBUMNAME:我们
我在这这个专辑是谁做的	MUSIC_SEARCH	ALBUMNAME:我在这
我很张含韵这个专辑怎么样	MUSIC_SEARCH	ALBUMNAME:我很张含韵
我很忙的歌曲内容都是什么	MUSIC_SEARCH	ALBUMNAME:我很忙
我很忙这个专辑是谁唱的	MUSIC_SEARCH	ALBUMNAME:我很忙
我很忙这个专辑是谁的	MUSIC_SEARCH	ALBUMNAME:我很忙
我很忙里有几首歌	MUSIC_SEARCH	ALBUMNAME:我很忙
我很忙里的歌都算不算流行音乐啊	MUSIC_SEARCH	GENRE:流行音乐	ALBUMNAME:我很忙
我很忙里都有哪些歌	MUSIC_SEARCH	ALBUMNAME:我很忙
我很忙里面歌曲的名字都是什么	MUSIC_SEARCH	ALBUMNAME:我很忙
我很忙里面的歌曲的曲风是什么	MUSIC_SEARCH	ALBUMNAME:我很忙
我忘了说这首歌在它的专辑里是第几个	MUSIC_SEARCH	TITLE:我忘了说
我怎能离开你是哪位著名歌手唱的么	MUSIC_SEARCH	TITLE:我怎能离开你
我怎舍得你的演唱家是谁	MUSIC_SEARCH	TITLE:我怎舍得你
我想知道情歌因你动听的歌词	MUSIC_SEARCH	TITLE:情歌因你动听
我想知道有关一枝独秀 这个专辑的信息	MUSIC_SEARCH	ALBUMNAME:一枝独秀
我想知道有关七不思议这个专辑的信息	MUSIC_SEARCH	ALBUMNAME:七不思议
我想知道有关七夕情缘这个专辑的信息	MUSIC_SEARCH	ALBUMNAME:七夕情缘
我想知道有关不忘初心这个专辑的信息	MUSIC_SEARCH	ALBUMNAME:不忘初心
我想知道有关为什么不早说这个专辑的信息	MUSIC_SEARCH	ALBUMNAME:为什么不早说
我想知道有关今夜烟花灿烂这个专辑的信息	MUSIC_SEARCH	ALBUMNAME:今夜烟花灿烂
我想知道有关全新飞翔这个专辑的信息	MUSIC_SEARCH	ALBUMNAME:全新飞翔
我想知道有关如初这个专辑的信息	MUSIC_SEARCH	ALBUMNAME:如初
我想知道有关小日子这个专辑的信息	MUSIC_SEARCH	ALBUMNAME:小日子
我想知道有关我忘了这个专辑的信息	MUSIC_SEARCH	ALBUMNAME:我忘了
我想知道有关无尽的烟火这个专辑的信息	MUSIC_SEARCH	ALBUMNAME:无尽的烟火
我想知道有关枪恋这个专辑的信息	MUSIC_SEARCH	ALBUMNAME:枪恋
我想知道有关燃烧寂寞这个专辑的信息	MUSIC_SEARCH	ALBUMNAME:燃烧寂寞
我想知道有关舍不得这个专辑的信息	MUSIC_SEARCH	ALBUMNAME:舍不得
我想知道有关遗憾这个专辑的信息	MUSIC_SEARCH	ALBUMNAME:遗憾
我想知道有关醉佳时分这个专辑的信息	MUSIC_SEARCH	ALBUMNAME:醉佳时分
我想知道有关预谋这个专辑的信息	MUSIC_SEARCH	ALBUMNAME:预谋
我想知道爱似林一峰的歌词	MUSIC_SEARCH	TITLE:爱似林一峰
我想知道白痴的歌词	MUSIC_SEARCH	TITLE:白痴
我想知道致我们终将逝去的青春的歌词	MUSIC_SEARCH	TITLE:致我们终将逝去的青春
我愿你知道这首歌是什么时候演出的	MUSIC_SEARCH	TITLE:我愿你知道
我是个好老婆在哪个专辑里	MUSIC_SEARCH	TITLE:我是个好老婆
我是个需要很多爱的人现在还流行吗	MUSIC_SEARCH	TITLE:我是个需要很多爱的人
我是帅哥的专辑是什么时候发行的	MUSIC_SEARCH	TITLE:我是帅哥
我是海棠里面都是那个年代的歌	MUSIC_SEARCH	ALBUMNAME:我是海棠
我是海雅谷慕这张专辑的发行公司是什么	MUSIC_SEARCH	ALBUMNAME:我是海雅谷慕
我是海雅谷慕里的歌都算不算流行音乐啊	MUSIC_SEARCH	GENRE:流行音乐	ALBUMNAME:我是海雅谷慕
我是海雅谷慕里面有哪几首歌	MUSIC_SEARCH	ALBUMNAME:我是海雅谷慕
我曾爱过一个男孩的原唱是谁	MUSIC_SEARCH	TITLE:我曾爱过一个男孩
我有什么专辑	MUSIC_SEARCH
我有几首德语歌曲	MUSIC_SEARCH	GENRE:德语歌曲
我的乡村播放列表	MUSIC_SEARCH	GENRE:乡村
我的伴奏播放列表	MUSIC_SEARCH	GENRE:伴奏
我的全部属于什么音乐	MUSIC_SEARCH	TITLE:我的全部
我的夏绿蒂播放列表	MUSIC_SEARCH	ARTIST_OR_COMPOSER:夏绿蒂
我的婚礼播放列表	MUSIC_SEARCH	GENRE:婚礼
我的巫迪文播放列表	MUSIC_SEARCH	ARTIST_OR_COMPOSER:巫迪文
我的张玮纶播放列表	MUSIC_SEARCH	ARTIST_OR_COMPOSER:张玮纶
我的手机里有五月天的歌么	MUSIC_SEARCH	ARTIST_OR_COMPOSER:五月天
我的手机里有群星的歌么	MUSIC_SEARCH	ARTIST_OR_COMPOSER:群星
我的柔情歌曲播放列表	MUSIC_SEARCH	GENRE:柔情歌曲
我的校园音乐播放列表	MUSIC_SEARCH	GENRE:校园音乐
我的歌声里什么时候发行	MUSIC_SEARCH	ALBUMNAME:我的歌声里
我的民谣歌曲播放列表	MUSIC_SEARCH	GENRE:民谣歌曲
我的爱伦奈维尔播放列表	MUSIC_SEARCH	ARTIST_OR_COMPOSER:爱伦奈维尔
我的爱对你说来自于什么年代	MUSIC_SEARCH	TITLE:我的爱对你说
我的爵士歌曲播放列表	MUSIC_SEARCH	GENRE:爵士歌曲
我的王菲时代这个专辑如何	MUSIC_SEARCH	ALBUMNAME:我的王菲时代
我的珍珠姐姐播放列表	MUSIC_SEARCH	ARTIST_OR_COMPOSER:珍珠姐姐
我的生存之道是什么风格的歌曲	MUSIC_SEARCH	TITLE:我的生存之道
我的电子音乐播放列表	MUSIC_SEARCH	GENRE:电子音乐
我的芭芭拉史翠姗播放列表	MUSIC_SEARCH	ARTIST_OR_COMPOSER:芭芭拉史翠姗
我的蒙古语歌播放列表	MUSIC_SEARCH	GENRE:蒙古语歌
我的蜜雪薇琪播放列表	MUSIC_SEARCH	ARTIST_OR_COMPOSER:蜜雪薇琪
我的谷本贵义播放列表	MUSIC_SEARCH	ARTIST_OR_COMPOSER:谷本贵义
我的郑伟康播放列表	MUSIC_SEARCH	ARTIST_OR_COMPOSER:郑伟康
我的香港歌曲播放列表	MUSIC_SEARCH	GENRE:香港歌曲
我的黄祺铭播放列表	MUSIC_SEARCH	ARTIST_OR_COMPOSER:黄祺铭
我真的好想你这个专辑怎么样	MUSIC_SEARCH	ALBUMNAME:我真的好想你
我知道你离我不远是谁发行的专辑	MUSIC_SEARCH	ALBUMNAME:我知道你离我不远
我要下载乌苏里船歌这首歌	MUSIC_SEARCH	TITLE:乌苏里船歌
我要下载恩赐这首歌	MUSIC_SEARCH	TITLE:恩赐
我要下载月儿弯这首歌	MUSIC_SEARCH	TITLE:月儿弯
我要下载燃烧青春火焰这首歌	MUSIC_SEARCH	TITLE:燃烧青春火焰
我要听经典摇滚乐	MUSIC_SEARCH	GENRE:经典摇滚乐
我要找一下硬摇滚	MUSIC_SEARCH	GENRE:硬摇滚
我要找一找刘彩星的歌	MUSIC_SEARCH	ARTIST_OR_COMPOSER:刘彩星
我要找找中文歌曲	MUSIC_SEARCH	GENRE:中文歌曲
我要找找感人情歌	MUSIC_SEARCH	GENRE:感人情歌
我要找拉丁音乐	MUSIC_SEARCH	GENRE:拉丁音乐
我要找萨克斯曲	MUSIC_SEARCH	GENRE:萨克斯曲
我要搜索民谣歌曲	MUSIC_SEARCH	GENRE:民谣歌曲
我要搜索甜蜜的音乐	MUSIC_SEARCH	GENRE:甜蜜的音乐
我要搜索酒吧的音乐	MUSIC_SEARCH	GENRE:酒吧的音乐
我要查找帕瓦罗蒂演出的歌剧	MUSIC_SEARCH	ARTIST_OR_COMPOSER:帕瓦罗蒂	GENRE:歌剧
我要看看这个曲子的歌词	MUSIC_PLAY	ANAPHOR:这个曲子
我要飞是哪个电影里的歌曲么	MUSIC_SEARCH	TITLE:我要飞
我迷上了一种叫做音乐的东西这首歌所在的专辑是什么时候发行的	MUSIC_SEARCH	TITLE:我迷上了一种叫做音乐的东西
我都有什么歌	MUSIC_SEARCH
戴玉强唱过的想和你在一起	MUSIC_SEARCH	ARTIST_OR_COMPOSER:戴玉强	TITLE:想和你在一起
打工十二月是哪里的歌曲	MUSIC_SEARCH	TITLE:打工十二月
找一下七十年代的经典摇滚乐	MUSIC_SEARCH	year:七十年代	GENRE:经典摇滚乐
找一下中提琴类型的音乐	MUSIC_SEARCH	GENRE:中提琴
找一下九十年代奥运会主题曲	MUSIC_SEARCH	year:九十年代	TITLE:奥运会主题曲
找一下九十年代的情歌	MUSIC_SEARCH	year:九十年代
找一下九十年代的经典动漫歌曲	MUSIC_SEARCH	year:九十年代	GENRE:动漫歌曲
找一下人来人往这首歌	MUSIC_SEARCH	TITLE:人来人往
找一下今天等我来这首歌	MUSIC_SEARCH	TITLE:今天等我来
找一下以爱之名里面的歌曲	MUSIC_SEARCH	ALBUMNAME:以爱之名
找一下共产主义红歌	MUSIC_SEARCH	GENRE:共产主义红歌
找一下单簧管类型的音乐	MUSIC_SEARCH	GENRE:单簧管
找一下原来这里没有你这首歌	MUSIC_SEARCH	TITLE:原来这里没有你
找一下双簧管类型的音乐	MUSIC_SEARCH	GENRE:双簧管
找一下吉他类型的音乐	MUSIC_SEARCH	GENRE:吉他
找一下后台这首歌	MUSIC_SEARCH	TITLE:后台
找一下因你而在里面的歌曲	MUSIC_SEARCH	ALBUMNAME:因你而在
找一下夕阳无限好这首歌	MUSIC_SEARCH	TITLE:夕阳无限好
找一下大提琴类型的音乐	MUSIC_SEARCH	GENRE:大提琴
找一下太阳照常升起这首歌	MUSIC_SEARCH	TITLE:太阳照常升起
找一下好歌献给你这首歌	MUSIC_SEARCH	TITLE:好歌献给你
找一下富士山下这首歌	MUSIC_SEARCH	TITLE:富士山下
找一下小提琴类型的音乐	MUSIC_SEARCH	GENRE:小提琴
找一下岁月如歌这首歌	MUSIC_SEARCH	TITLE:岁月如歌
找一下帕瓦罗蒂的歌剧	MUSIC_SEARCH	ARTIST_OR_COMPOSER:帕瓦罗蒂	GENRE:歌剧
找一下忽然难过这首歌	MUSIC_SEARCH	TITLE:忽然难过
找一下情深怎么办这首歌	MUSIC_SEARCH	TITLE:情深怎么办
找一下愈想愈无谓这首歌	MUSIC_SEARCH	TITLE:愈想愈无谓
找一下我怎么可以哭这首歌	MUSIC_SEARCH	TITLE:我怎么可以哭
找一下我的理想这首歌	MUSIC_SEARCH	TITLE:我的理想
找一下打得火热这首歌	MUSIC_SEARCH	TITLE:打得火热
找一下放下来这首歌	MUSIC_SEARCH	TITLE:放下来
找一下新闻女郎这首歌	MUSIC_SEARCH	TITLE:新闻女郎
找一下有了你这首歌	MUSIC_SEARCH	TITLE:有了你
找一下海阔天空这首歌	MUSIC_SEARCH	TITLE:海阔天空
找一下爱是怀疑这首歌	MUSIC_SEARCH	TITLE:爱是怀疑
找一下爱的傀儡这首歌	MUSIC_SEARCH	TITLE:爱的傀儡
找一下狼来了这首歌	MUSIC_SEARCH	TITLE:狼来了
找一下甜美的音乐	MUSIC_SEARCH	GENRE:甜美的音乐
找一下生无所求里面的歌曲	MUSIC_SEARCH	ALBUMNAME:生无所求
找一下电吉他类型的音乐	MUSIC_SEARCH	GENRE:电吉他
找一下短笛类型的音乐	MUSIC_SEARCH	GENRE:短笛
找一下竖琴类型的音乐	MUSIC_SEARCH	GENRE:竖琴
找一下粤语残片这首歌	MUSIC_SEARCH	TITLE:粤语残片
找一下英国管类型的音乐	MUSIC_SEARCH	GENRE:英国管
找一下请相信我这首歌	MUSIC_SEARCH	TITLE:请相信我
找一下谢谢这首歌	MUSIC_SEARCH	TITLE:谢谢
找一下贝司类型的音乐	MUSIC_SEARCH	GENRE:贝司
找一下跨时代里面的歌曲	MUSIC_SEARCH	ALBUMNAME:跨时代
找一下长笛类型的音乐	MUSIC_SEARCH	GENRE:长笛
找一下防不胜防这首歌	MUSIC_SEARCH	TITLE:防不胜防
找一下龙文这首歌	MUSIC_SEARCH	TITLE:龙文
找一个吉他曲	MUSIC_SEARCH	GENRE:吉他曲
找一八十年代奥运会主题曲	MUSIC_SEARCH	year:八十年代	TITLE:奥运会主题曲
找一找一家人这首歌	MUSIC_SEARCH	TITLE:一家人
找一找不死的梦这首歌	MUSIC_SEARCH	TITLE:不死的梦
找一找专辑摇滚类型的音乐	MUSIC_SEARCH	GENRE:专辑摇滚
找一找为何带他走这首歌	MUSIC_SEARCH	TITLE:为何带他走
找一找会说话的哑巴这首歌	MUSIC_SEARCH	TITLE:会说话的哑巴
找一找你是我的女人这首歌	MUSIC_SEARCH	TITLE:你是我的女人
找一找全心来跟我这首歌	MUSIC_SEARCH	TITLE:全心来跟我
找一找其中一位这首歌	MUSIC_SEARCH	TITLE:其中一位
找一找冷却音乐类型的音乐	MUSIC_SEARCH	GENRE:冷却音乐
找一找印度类型的音乐	MUSIC_SEARCH	GENRE:印度
找一找另类金属类型的音乐	MUSIC_SEARCH	GENRE:另类金属
找一找地球战士这首歌	MUSIC_SEARCH	TITLE:地球战士
找一找大侠这首歌	MUSIC_SEARCH	TITLE:大侠
找一找大节拍类型的音乐	MUSIC_SEARCH	GENRE:大节拍
找一找好听的轻音乐	MUSIC_SEARCH	GENRE:轻音乐
找一找完美这首歌	MUSIC_SEARCH	TITLE:完美
找一找怀旧的乐曲	MUSIC_SEARCH	GENRE:怀旧的乐曲
找一找情境音乐类型的音乐	MUSIC_SEARCH	GENRE:情境音乐
找一找感人的音乐	MUSIC_SEARCH	GENRE:感人的音乐
找一找无心人这首歌	MUSIC_SEARCH	TITLE:无心人
找一找极小派乐风类型的音乐	MUSIC_SEARCH	GENRE:极小派乐风
找一找歌曲Command	MUSIC_SEARCH	TITLE:Command
找一找歌曲IMISSYOU	MUSIC_SEARCH	TITLE:IMISSYOU
找一找歌曲Natural	MUSIC_SEARCH	TITLE:Natural
找一找歌曲一段情	MUSIC_SEARCH	TITLE:一段情
找一找歌曲不用人陪	MUSIC_SEARCH	TITLE:不用人陪
找一找歌曲不能溶化的冰	MUSIC_SEARCH	TITLE:不能溶化的冰
找一找歌曲不要带他走	MUSIC_SEARCH	TITLE:不要带他走
找一找歌曲他的女人	MUSIC_SEARCH	TITLE:他的女人
找一找歌曲你是我的温柔	MUSIC_SEARCH	TITLE:你是我的温柔
找一找歌曲听话了	MUSIC_SEARCH	TITLE:听话了
找一找歌曲回家真好	MUSIC_SEARCH	TITLE:回家真好
找一找歌曲情深的一句	MUSIC_SEARCH	TITLE:情深的一句
找一找歌曲月老	MUSIC_SEARCH	TITLE:月老
找一找歌曲爱人皇后	MUSIC_SEARCH	TITLE:爱人皇后
找一找歌曲舞吧	MUSIC_SEARCH	TITLE:舞吧
找一找浪淘沙这首歌	MUSIC_SEARCH	TITLE:浪淘沙
找一找痴心错付这首歌	MUSIC_SEARCH	TITLE:痴心错付
找一找真心话这首歌	MUSIC_SEARCH	TITLE:真心话
找一找硬摇滚类型的音乐	MUSIC_SEARCH	GENRE:硬摇滚
找一找继续流浪这首歌	MUSIC_SEARCH	TITLE:继续流浪
找一找车库类型的音乐	MUSIC_SEARCH	GENRE:车库
找一找迷幻舞曲类型的音乐	MUSIC_SEARCH	GENRE:迷幻舞曲
找一找迷幻音乐类型的音乐	MUSIC_SEARCH	GENRE:迷幻音乐
找一找非洲音乐	MUSIC_SEARCH	GENRE:非洲音乐
找一找高科技舞曲类型的音乐	MUSIC_SEARCH	GENRE:高科技舞曲
找刘虹翎的你比从前快乐吧	MUSIC_SEARCH	ARTIST_OR_COMPOSER:刘虹翎	TITLE:你比从前快乐
找叶倩文的有过去的人吧	MUSIC_SEARCH	ARTIST_OR_COMPOSER:叶倩文	TITLE:有过去的人
找叶惠美这个专辑	MUSIC_SEARCH	ALBUMNAME:叶惠美
找吻乐队的四季天吧	MUSIC_SEARCH	ARTIST_OR_COMPOSER:吻乐队	TITLE:四季天
找基尚的把他换作你吧	MUSIC_SEARCH	ARTIST_OR_COMPOSER:基尚	TITLE:把他换作你
找天台这个专辑	MUSIC_SEARCH	ALBUMNAME:天台
找幸福了然后呢这个专辑	MUSIC_SEARCH	ALBUMNAME:幸福了然后呢
找廖书凡的两名男子街头相遇吧	MUSIC_SEARCH	ARTIST_OR_COMPOSER:廖书凡	TITLE:两名男子街头相遇
找张学友的歌	MUSIC_SEARCH	ARTIST_OR_COMPOSER:张学友
找张惠妹的歌曲	MUSIC_SEARCH	ARTIST_OR_COMPOSER:张惠妹
找找17岁这首歌	MUSIC_SEARCH	TITLE:17岁
找找一起嗌这首歌	MUSIC_SEARCH	TITLE:一起嗌
找找九十年代的经典歌曲	MUSIC_SEARCH	year:九十年代	GENRE:经典歌曲
找找享用我的姓这首歌	MUSIC_SEARCH	TITLE:享用我的姓
找找你的野蛮男友这首歌	MUSIC_SEARCH	TITLE:你的野蛮男友
找找原来的革命歌曲	MUSIC_SEARCH	GENRE:革命歌曲
找找圣诞节歌曲	MUSIC_SEARCH	GENRE:圣诞节歌曲
找找天天想你这首歌	MUSIC_SEARCH	TITLE:天天想你
找找好听的背景音乐	MUSIC_SEARCH	GENRE:背景音乐
找找好听的钢琴曲	MUSIC_SEARCH	GENRE:钢琴曲
找找孙燕姿的歌	MUSIC_SEARCH	ARTIST_OR_COMPOSER:孙燕姿
找找心照这首歌	MUSIC_SEARCH	TITLE:心照
找找情人节歌曲	MUSIC_SEARCH	GENRE:情人节歌曲
找找我爱你这首歌	MUSIC_SEARCH	TITLE:我爱你
找找挂念这首歌	MUSIC_SEARCH	TITLE:挂念
找找是我吗这首歌	MUSIC_SEARCH	TITLE:是我吗
找找最近三年出的专辑	MUSIC_SEARCH	year:最近三年
找找某年冬季这首歌	MUSIC_SEARCH	TITLE:某年冬季
找找歌曲偷听女孩心	MUSIC_SEARCH	TITLE:偷听女孩心
找找歌曲再吻我吧	MUSIC_SEARCH	TITLE:再吻我吧
找找歌曲后悔	MUSIC_SEARCH	TITLE:后悔
找找歌曲地球的心声	MUSIC_SEARCH	TITLE:地球的心声
找找歌曲多想你好	MUSIC_SEARCH	TITLE:多想你好
找找歌曲归宿	MUSIC_SEARCH	TITLE:归宿
找找歌曲忠于自己	MUSIC_SEARCH	TITLE:忠于自己
找找歌曲情种	MUSIC_SEARCH	TITLE:情种
找找歌曲愈爱愈烦	MUSIC_SEARCH	TITLE:愈爱愈烦
找找歌曲旧情人	MUSIC_SEARCH	TITLE:旧情人
找找歌曲来生缘	MUSIC_SEARCH	TITLE:来生缘
找找歌曲爱不完	MUSIC_SEARCH	TITLE:爱不完
找找歌曲缘份	MUSIC_SEARCH	TITLE:缘份
找找歌曲茧人	MUSIC_SEARCH	TITLE:茧人
找找歌曲请你莫忘我	MUSIC_SEARCH	TITLE:请你莫忘我
找找爱你一万年这首歌	MUSIC_SEARCH	TITLE:爱你一万年
找找电子音乐	MUSIC_SEARCH	GENRE:电子音乐
找找痴心不再流行这首歌	MUSIC_SEARCH	TITLE:痴心不再流行
找找自然定律这首歌	MUSIC_SEARCH	TITLE:自然定律
找找苦缠这首歌	MUSIC_SEARCH	TITLE:苦缠
找找鸽子情缘这首歌	MUSIC_SEARCH	TITLE:鸽子情缘
找拾伍这个专辑	MUSIC_SEARCH	ALBUMNAME:拾伍
找李瑞熙的幸福就好吧	MUSIC_SEARCH	ARTIST_OR_COMPOSER:李瑞熙	TITLE:幸福就好
找林二汶的每当你抱着我吧	MUSIC_SEARCH	ARTIST_OR_COMPOSER:林二汶	TITLE:每当你抱着我
找欧喷爱的精舞门吧	MUSIC_SEARCH	ARTIST_OR_COMPOSER:欧喷爱	TITLE:精舞门
找毅光年的歌曲	MUSIC_SEARCH	ARTIST_OR_COMPOSER:毅光年
找舞动全世界这个专辑	MUSIC_SEARCH	ALBUMNAME:舞动全世界
找范思威的忐忑吧	MUSIC_SEARCH	ARTIST_OR_COMPOSER:范思威	TITLE:忐忑
找邓丽君唱的歌曲	MUSIC_SEARCH	ARTIST_OR_COMPOSER:邓丽君
找那个刘虹翎的那个甘苦的外籍船员	MUSIC_SEARCH	ARTIST_OR_COMPOSER:刘虹翎	TITLE:甘苦的外籍船员
找那个君君的那个茶花姑娘	MUSIC_SEARCH	ARTIST_OR_COMPOSER:君君	TITLE:茶花姑娘
找那个埃尔顿的那个边缘	MUSIC_SEARCH	ARTIST_OR_COMPOSER:埃尔顿	TITLE:边缘
找那个朴志胤的那个我的眼泪不为你说慌	MUSIC_SEARCH	ARTIST_OR_COMPOSER:朴志胤	TITLE:我的眼泪不为你说慌
找那个河琳的那个渴望的地方	MUSIC_SEARCH	ARTIST_OR_COMPOSER:河琳	TITLE:渴望的地方
找那个王识贤的那个朵朵	MUSIC_SEARCH	ARTIST_OR_COMPOSER:王识贤	TITLE:朵朵
找那个珍珠姐姐的那个同创梦想	MUSIC_SEARCH	ARTIST_OR_COMPOSER:珍珠姐姐	TITLE:同创梦想
找那个立威廉的那个爱你啊	MUSIC_SEARCH	ARTIST_OR_COMPOSER:立威廉	TITLE:爱你啊
找那个谭扬的那个两条路	MUSIC_SEARCH	ARTIST_OR_COMPOSER:谭扬	TITLE:两条路
找那个陈逸男的那个喜欢你的名字	MUSIC_SEARCH	ARTIST_OR_COMPOSER:陈逸男	TITLE:喜欢你的名字
找鲍必提的阳光灿烂的夜里吧	MUSIC_SEARCH	ARTIST_OR_COMPOSER:鲍必提	TITLE:阳光灿烂的夜里
抉择是谁演唱的	MUSIC_SEARCH	TITLE:抉择
把有的动漫歌曲列出来	MUSIC_SEARCH	GENRE:动漫歌曲
披头士(甲壳虫)乐队的寻找李慧珍	MUSIC_SEARCH	ARTIST_OR_COMPOSER:披头士(甲壳虫)乐队	TITLE:寻找李慧珍
拥挤的房子的好想谈恋爱	MUSIC_SEARCH	ARTIST_OR_COMPOSER:拥挤的房子	TITLE:好想谈恋爱
拾伍什么时候发行	MUSIC_SEARCH	ALBUMNAME:拾伍
拾伍里面全是什么类型的歌	MUSIC_SEARCH	ALBUMNAME:拾伍
拾碎这个专辑是谁做的	MUSIC_SEARCH	ALBUMNAME:拾碎
指环王原声歌曲有哪些	MUSIC_SEARCH	ALBUMNAME:指环王原声歌曲
指环王原声音乐	MUSIC_SEARCH	ALBUMNAME:指环王原声音乐
挑信哪天发行的	MUSIC_SEARCH	ALBUMNAME:挑信
挥别旧岁算不算是比较非主流的音乐	MUSIC_SEARCH	GENRE:非主流	TITLE:挥别旧岁
捉迷藏是一首新歌么	MUSIC_SEARCH	TITLE:捉迷藏
搜一下一晚长大这首歌	MUSIC_SEARCH	TITLE:一晚长大
搜一下不该爱上你这首歌	MUSIC_SEARCH	TITLE:不该爱上你
搜一下你是我所有这首歌	MUSIC_SEARCH	TITLE:你是我所有
搜一下千万个不愿意这首歌	MUSIC_SEARCH	TITLE:千万个不愿意
搜一下口琴类型的音乐	MUSIC_SEARCH	GENRE:口琴
搜一下古筝类型的音乐	MUSIC_SEARCH	GENRE:古筝
搜一下小鼓类型的音乐	MUSIC_SEARCH	GENRE:小鼓
搜一下心声共鸣这首歌	MUSIC_SEARCH	TITLE:心声共鸣
搜一下心蓝这首歌	MUSIC_SEARCH	TITLE:心蓝
搜一下我的苦你明白这首歌	MUSIC_SEARCH	TITLE:我的苦你明白
搜一下手风琴类型的音乐	MUSIC_SEARCH	GENRE:手风琴
搜一下扬琴类型的音乐	MUSIC_SEARCH	GENRE:扬琴
搜一下整体这首歌	MUSIC_SEARCH	TITLE:整体
搜一下最好的朋友这首歌	MUSIC_SEARCH	TITLE:最好的朋友
搜一下架子鼓类型的音乐	MUSIC_SEARCH	GENRE:架子鼓
搜一下歌曲一辈子的错	MUSIC_SEARCH	TITLE:一辈子的错
搜一下歌曲不谈情感	MUSIC_SEARCH	TITLE:不谈情感
搜一下歌曲争气	MUSIC_SEARCH	TITLE:争气
搜一下歌曲冬季不下雪	MUSIC_SEARCH	TITLE:冬季不下雪
搜一下歌曲匹夫最勇	MUSIC_SEARCH	TITLE:匹夫最勇
搜一下歌曲好日子	MUSIC_SEARCH	TITLE:好日子
搜一下歌曲宁愿我伤心	MUSIC_SEARCH	TITLE:宁愿我伤心
搜一下歌曲寂寞时分	MUSIC_SEARCH	TITLE:寂寞时分
搜一下歌曲微笑	MUSIC_SEARCH	TITLE:微笑
搜一下歌曲我只想你好	MUSIC_SEARCH	TITLE:我只想你好
搜一下歌曲教你如何不爱他	MUSIC_SEARCH	TITLE:教你如何不爱他
搜一下歌曲最受欢迎男歌手	MUSIC_SEARCH	TITLE:最受欢迎男歌手
搜一下歌曲没有你没有我	MUSIC_SEARCH	TITLE:没有你没有我
搜一下歌曲火焰心	MUSIC_SEARCH	TITLE:火焰心
搜一下歌曲男孩女孩	MUSIC_SEARCH	TITLE:男孩女孩
搜一下死剩把口这首歌	MUSIC_SEARCH	TITLE:死剩把口
搜一下爱无知这首歌	MUSIC_SEARCH	TITLE:爱无知
搜一下爱火烧不尽这首歌	MUSIC_SEARCH	TITLE:爱火烧不尽
搜一下现实是场梦这首歌	MUSIC_SEARCH	TITLE:现实是场梦
搜一下珍爱舞台这首歌	MUSIC_SEARCH	TITLE:珍爱舞台
搜一下电子琴类型的音乐	MUSIC_SEARCH	GENRE:电子琴
搜一下短号大管类型的音乐	MUSIC_SEARCH	GENRE:短号大管
搜一下笨小孩这首歌	MUSIC_SEARCH	TITLE:笨小孩
搜一下管风琴类型的音乐	MUSIC_SEARCH	GENRE:管风琴
搜一下箫类型的音乐	MUSIC_SEARCH	GENRE:箫
搜一下葫芦丝类型的音乐	MUSIC_SEARCH	GENRE:葫芦丝
搜一下长号类型的音乐	MUSIC_SEARCH	GENRE:长号
搜一下风琴类型的音乐	MUSIC_SEARCH	GENRE:风琴
搜搜一朵鲜花这首歌	MUSIC_SEARCH	TITLE:一朵鲜花
搜搜台湾同胞这首歌	MUSIC_SEARCH	TITLE:台湾同胞
搜搜喂鸡这首歌	MUSIC_SEARCH	TITLE:喂鸡
搜搜在路上这首歌	MUSIC_SEARCH	TITLE:在路上
搜搜怀念战友这首歌	MUSIC_SEARCH	TITLE:怀念战友
搜搜我和你这首歌	MUSIC_SEARCH	TITLE:我和你
搜搜映山红这首歌	MUSIC_SEARCH	TITLE:映山红
搜搜有心无力这首歌	MUSIC_SEARCH	TITLE:有心无力
搜搜毛衣这首歌	MUSIC_SEARCH	TITLE:毛衣
搜搜玄之又玄这首歌	MUSIC_SEARCH	TITLE:玄之又玄
搜搜痛这首歌	MUSIC_SEARCH	TITLE:痛
搜搜草帽歌这首歌	MUSIC_SEARCH	TITLE:草帽歌
搜搜话我知这首歌	MUSIC_SEARCH	TITLE:话我知
搜搜飞翔这首歌	MUSIC_SEARCH	TITLE:飞翔
搜素国际歌	MUSIC_SEARCH	TITLE:国际歌
搜索B-BOY类型的音乐	MUSIC_SEARCH	GENRE:B-BOY
搜索BEYOND的歌曲	MUSIC_SEARCH	ARTIST_OR_COMPOSER:BEYOND
搜索Backstreet Boys的歌曲	MUSIC_SEARCH	ARTIST_OR_COMPOSER:Backstreet Boys
搜索BigBang的歌曲	MUSIC_SEARCH	ARTIST_OR_COMPOSER:BigBang
搜索Blues类型的音乐	MUSIC_SEARCH	GENRE:Blues
搜索DJ类型的音乐	MUSIC_SEARCH	GENRE:DJ
搜索Eminem的歌曲	MUSIC_SEARCH	ARTIST_OR_COMPOSER:Eminem
搜索F4的歌曲	MUSIC_SEARCH	ARTIST_OR_COMPOSER:F4
搜索Graffiti类型的音乐	MUSIC_SEARCH	GENRE:Graffiti
搜索Lady GaGa的歌曲	MUSIC_SEARCH	ARTIST_OR_COMPOSER:Lady GaGa
搜索Linkin Park的歌曲	MUSIC_SEARCH	ARTIST_OR_COMPOSER:Linkin Park
搜索MC类型的音乐	MUSIC_SEARCH	GENRE:MC
搜索Michael Jackson的歌曲	MUSIC_SEARCH	ARTIST_OR_COMPOSER:Michael Jackson
搜索SHE的歌曲	MUSIC_SEARCH	ARTIST_OR_COMPOSER:SHE
搜索Tank的歌曲	MUSIC_SEARCH	ARTIST_OR_COMPOSER:Tank
搜索Twins的歌曲	MUSIC_SEARCH	ARTIST_OR_COMPOSER:Twins
搜索WestLife的歌曲	MUSIC_SEARCH	ARTIST_OR_COMPOSER:WestLife
搜索k歌之王这首歌	MUSIC_SEARCH	TITLE:k歌之王
搜索psy的歌曲	MUSIC_SEARCH	ARTIST_OR_COMPOSER:psy
搜索一下彭丽媛尝过的歌	MUSIC_SEARCH	ARTIST_OR_COMPOSER:彭丽媛
搜索一下欧美的歌手	MUSIC_SEARCH	GENRE:欧美
搜索一下老歌	MUSIC_SEARCH	GENRE:老歌
搜索一下酒吧的歌曲	MUSIC_SEARCH	GENRE:酒吧的歌曲
搜索一千年以后	MUSIC_SEARCH	TITLE:一千年以后
搜索一起长大这个专辑	MUSIC_SEARCH	ALBUMNAME:一起长大
搜索丁丁的歌曲	MUSIC_SEARCH	ARTIST_OR_COMPOSER:丁丁
搜索丁浩然的歌曲	MUSIC_SEARCH	ARTIST_OR_COMPOSER:丁浩然
搜索七十年代的经典摇滚乐	MUSIC_SEARCH	year:七十年代	GENRE:经典摇滚乐
搜索七里香这个专辑	MUSIC_SEARCH	ALBUMNAME:七里香
搜索上海一九四三	MUSIC_SEARCH	TITLE:上海一九四三
搜索不再让你孤单这首歌	MUSIC_SEARCH	TITLE:不再让你孤单
搜索不来也不去这首歌	MUSIC_SEARCH	TITLE:不来也不去
搜索与我常在这首歌	MUSIC_SEARCH	TITLE:与我常在
搜索与爱情有关这首歌曲	MUSIC_SEARCH	TITLE:与爱情有关
搜索专辑不可不信缘	MUSIC_SEARCH	ALBUMNAME:不可不信缘
搜索专辑乐行者	MUSIC_SEARCH	ALBUMNAME:乐行者
搜索专辑再会了	MUSIC_SEARCH	ALBUMNAME:再会了
搜索专辑双霸	MUSIC_SEARCH	ALBUMNAME:双霸
搜索专辑只知道此刻爱你	MUSIC_SEARCH	ALBUMNAME:只知道此刻爱你
搜索专辑回到你身边	MUSIC_SEARCH	ALBUMNAME:回到你身边
搜索专辑如果你是我的传说	MUSIC_SEARCH	ALBUMNAME:如果你是我的传说
搜索专辑情感的禁区	MUSIC_SEARCH	ALBUMNAME:情感的禁区
搜索专辑曹操	MUSIC_SEARCH	ALBUMNAME:曹操
搜索专辑第二天堂	MUSIC_SEARCH	ALBUMNAME:第二天堂
搜索专辑西界	MUSIC_SEARCH	ALBUMNAME:西界
搜索专辑音乐进化全过程	MUSIC_SEARCH	ALBUMNAME:音乐进化全过程
搜索世界未末日	MUSIC_SEARCH	TITLE:世界未末日
搜索世界音乐类型的音乐	MUSIC_SEARCH	GENRE:世界音乐
搜索东城卫的歌曲	MUSIC_SEARCH	ARTIST_OR_COMPOSER:东城卫
搜索东方神起的歌曲	MUSIC_SEARCH	ARTIST_OR_COMPOSER:东方神起
搜索东来东往的歌曲	MUSIC_SEARCH	ARTIST_OR_COMPOSER:东来东往
搜索东风破	MUSIC_SEARCH	TITLE:东风破
搜索两年前的歌曲	MUSIC_SEARCH	year:两年前
搜索两极的作曲家	MUSIC_SEARCH	TITLE:两极
搜索严爵的歌曲	MUSIC_SEARCH	ARTIST_OR_COMPOSER:严爵
搜索严艺丹的歌曲	MUSIC_SEARCH	ARTIST_OR_COMPOSER:严艺丹
搜索中世纪类型的音乐	MUSIC_SEARCH	GENRE:中世纪
搜索中岛爱的歌曲	MUSIC_SEARCH	ARTIST_OR_COMPOSER:中岛爱
搜索中岛美嘉的歌曲	MUSIC_SEARCH	ARTIST_OR_COMPOSER:中岛美嘉
搜索中岛美雪的歌曲	MUSIC_SEARCH	ARTIST_OR_COMPOSER:中岛美雪
搜索主动的歌曲信息	MUSIC_SEARCH	TITLE:主动
搜索久石让的歌曲	MUSIC_SEARCH	ARTIST_OR_COMPOSER:久石让
搜索义勇军进行曲	MUSIC_SEARCH	TITLE:义勇军进行曲
搜索乌兰图雅的歌曲	MUSIC_SEARCH	ARTIST_OR_COMPOSER:乌兰图雅
搜索乌兰托娅的歌曲	MUSIC_SEARCH	ARTIST_OR_COMPOSER:乌兰托娅
搜索乔洋的歌曲	MUSIC_SEARCH	ARTIST_OR_COMPOSER:乔洋
搜索九十年代的经典动漫歌曲	MUSIC_SEARCH	year:九十年代	GENRE:经典动漫歌曲
搜索乡村音乐	MUSIC_SEARCH	GENRE:乡村音乐
搜索乡村音乐类型的音乐	MUSIC_SEARCH	GENRE:乡村音乐
搜索于湉的歌曲	MUSIC_SEARCH	ARTIST_OR_COMPOSER:于湉
搜索云非非的歌曲	MUSIC_SEARCH	ARTIST_OR_COMPOSER:云非非
搜索五月天的歌曲	MUSIC_SEARCH	ARTIST_OR_COMPOSER:五月天
搜索井口裕香的歌曲	MUSIC_SEARCH	ARTIST_OR_COMPOSER:井口裕香
搜索代理仁的歌曲	MUSIC_SEARCH	ARTIST_OR_COMPOSER:代理仁
搜索任然的歌曲	MUSIC_SEARCH	ARTIST_OR_COMPOSER:任然
搜索任贤齐的歌曲	MUSIC_SEARCH	ARTIST_OR_COMPOSER:任贤齐
搜索任重的歌曲	MUSIC_SEARCH	ARTIST_OR_COMPOSER:任重
搜索伊藤由奈的歌曲	MUSIC_SEARCH	ARTIST_OR_COMPOSER:伊藤由奈
搜索伊藤静的歌曲	MUSIC_SEARCH	ARTIST_OR_COMPOSER:伊藤静
搜索伍佰的歌曲	MUSIC_SEARCH	ARTIST_OR_COMPOSER:伍佰
搜索伍华的歌曲	MUSIC_SEARCH	ARTIST_OR_COMPOSER:伍华
搜索伍思凯的歌曲	MUSIC_SEARCH	ARTIST_OR_COMPOSER:伍思凯
搜索会飞的贼这个专辑里面的轻音乐	MUSIC_SEARCH	GENRE:轻音乐	ALBUMNAME:会飞的贼
搜索伤感的音乐	MUSIC_SEARCH	GENRE:伤感的音乐
搜索何晟铭的歌曲	MUSIC_SEARCH	ARTIST_OR_COMPOSER:何晟铭
搜索何洁的歌曲	MUSIC_SEARCH	ARTIST_OR_COMPOSER:何洁
搜索何润东的歌曲	MUSIC_SEARCH	ARTIST_OR_COMPOSER:何润东
搜索何炅的歌曲	MUSIC_SEARCH	ARTIST_OR_COMPOSER:何炅
搜索何韵诗的歌曲	MUSIC_SEARCH	ARTIST_OR_COMPOSER:何韵诗
搜索你在我心里这首歌曲	MUSIC_SEARCH	TITLE:你在我心里
搜索你比从前快乐	MUSIC_SEARCH	TITLE:你比从前快乐
搜索你的背包这首歌	MUSIC_SEARCH	TITLE:你的背包
搜索你知道我在等你们分手吗这首歌	MUSIC_SEARCH	TITLE:你知道我在等你们分手吗
搜索侃侃的歌曲	MUSIC_SEARCH	ARTIST_OR_COMPOSER:侃侃
搜索依然范特西	MUSIC_SEARCH	ALBUMNAME:依然范特西
搜索依然范特西这个专辑	MUSIC_SEARCH	ALBUMNAME:依然范特西
搜索侧田的歌曲	MUSIC_SEARCH	ARTIST_OR_COMPOSER:侧田
搜索俞灏明的歌曲	MUSIC_SEARCH	ARTIST_OR_COMPOSER:俞灏明
搜索信乐团的歌曲	MUSIC_SEARCH	ARTIST_OR_COMPOSER:信乐团
搜索信的歌曲	MUSIC_SEARCH	ARTIST_OR_COMPOSER:信
搜索倪安东的歌曲	MUSIC_SEARCH	ARTIST_OR_COMPOSER:倪安东
搜索儿歌	MUSIC_SEARCH	GENRE:儿歌
搜索兄妹这首歌	MUSIC_SEARCH	TITLE:兄妹
搜索光良的歌曲	MUSIC_SEARCH	ARTIST_OR_COMPOSER:光良
搜索八十年代奥运会主题曲	MUSIC_SEARCH	year:八十年代	TITLE:奥运会主题曲
搜索八度空间	MUSIC_SEARCH	ALBUMNAME:八度空间
搜索八度空间这个专辑	MUSIC_SEARCH	ALBUMNAME:八度空间
搜索八度空间这首歌	MUSIC_SEARCH	ALBUMNAME:八度空间
搜索六哲的歌曲	MUSIC_SEARCH	ARTIST_OR_COMPOSER:六哲
搜索六月飞霜这首歌	MUSIC_SEARCH	TITLE:六月飞霜
搜索关不掉的月光这张专辑	MUSIC_SEARCH	ALBUMNAME:关不掉的月光
搜索关喆的歌曲	MUSIC_SEARCH	ARTIST_OR_COMPOSER:关喆
搜索关心妍的歌曲	MUSIC_SEARCH	ARTIST_OR_COMPOSER:关心妍
搜索冯曦妤的歌曲	MUSIC_SEARCH	ARTIST_OR_COMPOSER:冯曦妤
搜索冲浪男孩的歌曲信息	MUSIC_SEARCH	TITLE:冲浪男孩
搜索冷漠的歌曲	MUSIC_SEARCH	ARTIST_OR_COMPOSER:冷漠
搜索凤凰传奇的歌曲	MUSIC_SEARCH	ARTIST_OR_COMPOSER:凤凰传奇
搜索刀郎的歌曲	MUSIC_SEARCH	ARTIST_OR_COMPOSER:刀郎
搜索刘佳的歌曲	MUSIC_SEARCH	ARTIST_OR_COMPOSER:刘佳
搜索刘力扬的歌曲	MUSIC_SEARCH	ARTIST_OR_COMPOSER:刘力扬
搜索刘嘉亮的歌曲	MUSIC_SEARCH	ARTIST_OR_COMPOSER:刘嘉亮
搜索刘庭羽的歌曲	MUSIC_SEARCH	ARTIST_OR_COMPOSER:刘庭羽
搜索刘德华的歌曲	MUSIC_SEARCH	ARTIST_OR_COMPOSER:刘德华
搜索刘心的歌曲	MUSIC_SEARCH	ARTIST_OR_COMPOSER:刘心
搜索刘忻的歌曲	MUSIC_SEARCH	ARTIST_OR_COMPOSER:刘忻
搜索刘惜君的歌曲	MUSIC_SEARCH	ARTIST_OR_COMPOSER:刘惜君
搜索刘欢的歌曲	MUSIC_SEARCH	ARTIST_OR_COMPOSER:刘欢
搜索刘涛的歌曲	MUSIC_SEARCH	ARTIST_OR_COMPOSER:刘涛
搜索刘紫玲的歌曲	MUSIC_SEARCH	ARTIST_OR_COMPOSER:刘紫玲
搜索刘若英的歌曲	MUSIC_SEARCH	ARTIST_OR_COMPOSER:刘若英
搜索初音未来的歌	MUSIC_SEARCH	ARTIST_OR_COMPOSER:初音未来
搜索初音未来的歌曲	MUSIC_SEARCH	ARTIST_OR_COMPOSER:初音未来
搜索动力火车的歌曲	MUSIC_SEARCH	ARTIST_OR_COMPOSER:动力火车
搜索匿名的好友这首歌曲	MUSIC_SEARCH	TITLE:匿名的好友
搜索十一月的萧邦	MUSIC_SEARCH	ALBUMNAME:十一月的萧邦
搜索十一月的萧邦这个专辑	MUSIC_SEARCH	ALBUMNAME:十一月的萧邦
搜索半岛铁盒	MUSIC_SEARCH	TITLE:半岛铁盒
搜索华晨宇的歌曲	MUSIC_SEARCH	ARTIST_OR_COMPOSER:华晨宇
搜索卓依婷的歌曲	MUSIC_SEARCH	ARTIST_OR_COMPOSER:卓依婷
搜索卓文萱的歌曲	MUSIC_SEARCH	ARTIST_OR_COMPOSER:卓文萱
搜索单小源的歌曲	MUSIC_SEARCH	ARTIST_OR_COMPOSER:单小源
搜索南征北战的歌曲	MUSIC_SEARCH	ARTIST_OR_COMPOSER:南征北战
搜索南拳妈妈的歌曲	MUSIC_SEARCH	ARTIST_OR_COMPOSER:南拳妈妈
搜索卢广仲的歌曲	MUSIC_SEARCH	ARTIST_OR_COMPOSER:卢广仲
搜索卫兰的歌曲	MUSIC_SEARCH	ARTIST_OR_COMPOSER:卫兰
搜索去你的2000这个专辑	MUSIC_SEARCH	ALBUMNAME:去你的2000
搜索古典音乐	MUSIC_SEARCH	GENRE:古典音乐
搜索古巨基的歌曲	MUSIC_SEARCH	ARTIST_OR_COMPOSER:古巨基
搜索叫Q版一族的专辑	MUSIC_SEARCH	ALBUMNAME:Q版一族
搜索叫五时三十分的专辑	MUSIC_SEARCH	ALBUMNAME:五时三十分
搜索叫去你的2000的专辑	MUSIC_SEARCH	ALBUMNAME:去你的2000
搜索叫因为爱的专辑	MUSIC_SEARCH	ALBUMNAME:因为爱
搜索叫天意的专辑	MUSIC_SEARCH	ALBUMNAME:天意
搜索叫好想你的专辑	MUSIC_SEARCH	ALBUMNAME:好想你
搜索叫宅无处不在的专辑	MUSIC_SEARCH	ALBUMNAME:宅无处不在
搜索叫忘情水的专辑	MUSIC_SEARCH	ALBUMNAME:忘情水
搜索叫情未了的专辑	MUSIC_SEARCH	ALBUMNAME:情未了
搜索叫我是海棠的专辑	MUSIC_SEARCH	ALBUMNAME:我是海棠
搜索叫来生缘的专辑	MUSIC_SEARCH	ALBUMNAME:来生缘
搜索叫爱在刻骨铭心时的专辑	MUSIC_SEARCH	ALBUMNAME:爱在刻骨铭心时
搜索叫爱的空间的专辑	MUSIC_SEARCH	ALBUMNAME:爱的空间
搜索叫真我的风采的专辑	MUSIC_SEARCH	ALBUMNAME:真我的风采
搜索叫真生命的专辑	MUSIC_SEARCH	ALBUMNAME:真生命
搜索叫谢谢你的爱的专辑	MUSIC_SEARCH	ALBUMNAME:谢谢你的爱
搜索台北寂寞部屋这首歌	MUSIC_SEARCH	TITLE:台北寂寞部屋
搜索叶倩文的歌曲	MUSIC_SEARCH	ARTIST_OR_COMPOSER:叶倩文
搜索叶惠美	MUSIC_SEARCH	ALBUMNAME:叶惠美
搜索叶惠美这个专辑	MUSIC_SEARCH	ALBUMNAME:叶惠美
搜索司徒兰芳的歌曲	MUSIC_SEARCH	ARTIST_OR_COMPOSER:司徒兰芳
搜索名为你可知道我爱谁的专辑	MUSIC_SEARCH	ALBUMNAME:你可知道我爱谁
搜索名为偿还的专辑	MUSIC_SEARCH	ALBUMNAME:偿还
搜索名为初次尝到寂寞的专辑	MUSIC_SEARCH	ALBUMNAME:初次尝到寂寞
搜索名为千言万语的专辑	MUSIC_SEARCH	ALBUMNAME:千言万语
搜索名为南海姑娘的专辑	MUSIC_SEARCH	ALBUMNAME:南海姑娘
搜索名为天国的情人的专辑	MUSIC_SEARCH	ALBUMNAME:天国的情人
搜索名为小城故事的专辑	MUSIC_SEARCH	ALBUMNAME:小城故事
搜索名为往事如昨的专辑	MUSIC_SEARCH	ALBUMNAME:往事如昨
搜索名为快乐的恰恰姑娘的专辑	MUSIC_SEARCH	ALBUMNAME:快乐的恰恰姑娘
搜索名为水上人的专辑	MUSIC_SEARCH	ALBUMNAME:水上人
搜索名为淡淡幽情的专辑	MUSIC_SEARCH	ALBUMNAME:淡淡幽情
搜索名为漫步人生路的专辑	MUSIC_SEARCH	ALBUMNAME:漫步人生路
搜索名为甜蜜蜜的专辑	MUSIC_SEARCH	ALBUMNAME:甜蜜蜜
搜索名叫一只牛的异想世界的专辑	MUSIC_SEARCH	ALBUMNAME:一只牛的异想世界
搜索名叫不了情的专辑	MUSIC_SEARCH	ALBUMNAME:不了情
搜索名叫人间爱的专辑	MUSIC_SEARCH	ALBUMNAME:人间爱
搜索名叫再说一次我爱你的专辑	MUSIC_SEARCH	ALBUMNAME:再说一次我爱你
搜索名叫别把眉儿皱的专辑	MUSIC_SEARCH	ALBUMNAME:别把眉儿皱
搜索名叫声音的专辑	MUSIC_SEARCH	ALBUMNAME:声音
搜索名叫天开了的专辑	MUSIC_SEARCH	ALBUMNAME:天开了
搜索名叫如果有一天的专辑	MUSIC_SEARCH	ALBUMNAME:如果有一天
搜索名叫妹力新世纪的专辑	MUSIC_SEARCH	ALBUMNAME:妹力新世纪
搜索名叫心蓝的专辑	MUSIC_SEARCH	ALBUMNAME:心蓝
搜索名叫爱像一首歌的专辑	MUSIC_SEARCH	ALBUMNAME:爱像一首歌
搜索名叫爱无知的专辑	MUSIC_SEARCH	ALBUMNAME:爱无知
搜索名叫美丽的一天的专辑	MUSIC_SEARCH	ALBUMNAME:美丽的一天
搜索名字叫丝路的专辑	MUSIC_SEARCH	ALBUMNAME:丝路
搜索名字叫亲亲的专辑	MUSIC_SEARCH	ALBUMNAME:亲亲
搜索名字叫今天情人节的专辑	MUSIC_SEARCH	ALBUMNAME:今天情人节
搜索名字叫完美的一天的专辑	MUSIC_SEARCH	ALBUMNAME:完美的一天
搜索名字叫崇拜的专辑	MUSIC_SEARCH	ALBUMNAME:崇拜
搜索名字叫恋爱的力量的专辑	MUSIC_SEARCH	ALBUMNAME:恋爱的力量
搜索名字叫我爱邓丽君的专辑	MUSIC_SEARCH	ALBUMNAME:我爱邓丽君
搜索名字叫我要的幸福的专辑	MUSIC_SEARCH	ALBUMNAME:我要的幸福
搜索名字叫未完成的专辑	MUSIC_SEARCH	ALBUMNAME:未完成
搜索名字叫自选辑的专辑	MUSIC_SEARCH	ALBUMNAME:自选辑
搜索名字叫逆光的专辑	MUSIC_SEARCH	ALBUMNAME:逆光
搜索名字叫风筝的专辑	MUSIC_SEARCH	ALBUMNAME:风筝
搜索名字是一个小心愿的专辑	MUSIC_SEARCH	ALBUMNAME:一个小心愿
搜索名字是一封情书的专辑	MUSIC_SEARCH	ALBUMNAME:一封情书
搜索名字是再见我的爱人的专辑	MUSIC_SEARCH	ALBUMNAME:再见我的爱人
搜索名字是原乡人的专辑	MUSIC_SEARCH	ALBUMNAME:原乡人
搜索名字是又见炊烟的专辑	MUSIC_SEARCH	ALBUMNAME:又见炊烟
搜索名字是在水一方的专辑	MUSIC_SEARCH	ALBUMNAME:在水一方
搜索名字是姐妹的专辑	MUSIC_SEARCH	ALBUMNAME:姐妹
搜索名字是小村之恋的专辑	MUSIC_SEARCH	ALBUMNAME:小村之恋
搜索名字是永恒巨星典藏版的专辑	MUSIC_SEARCH	ALBUMNAME:永恒巨星典藏版
搜索名字是牵手的专辑	MUSIC_SEARCH	ALBUMNAME:牵手
搜索名字是的专辑歌声妹影	MUSIC_SEARCH	ALBUMNAME:歌声妹影
搜索名字是艳红小曲的专辑	MUSIC_SEARCH	ALBUMNAME:艳红小曲
搜索后弦的歌曲	MUSIC_SEARCH	ARTIST_OR_COMPOSER:后弦
搜索吕方的歌曲	MUSIC_SEARCH	ARTIST_OR_COMPOSER:吕方
搜索听一千遍后这首歌	MUSIC_SEARCH	TITLE:听一千遍后
搜索听妈妈的话	MUSIC_SEARCH	TITLE:听妈妈的话
搜索吴克羣的歌曲	MUSIC_SEARCH	ARTIST_OR_COMPOSER:吴克羣
搜索吴奇隆的歌曲	MUSIC_SEARCH	ARTIST_OR_COMPOSER:吴奇隆
搜索吴建豪的歌曲	MUSIC_SEARCH	ARTIST_OR_COMPOSER:吴建豪
搜索吴莫愁的歌曲	MUSIC_SEARCH	ARTIST_OR_COMPOSER:吴莫愁
搜索吴雨霏的歌曲	MUSIC_SEARCH	ARTIST_OR_COMPOSER:吴雨霏
搜索周传雄的歌曲	MUSIC_SEARCH	ARTIST_OR_COMPOSER:周传雄
搜索周华健的歌曲	MUSIC_SEARCH	ARTIST_OR_COMPOSER:周华健
搜索周晓鸥的歌曲	MUSIC_SEARCH	ARTIST_OR_COMPOSER:周晓鸥
搜索周杰伦的歌	MUSIC_SEARCH	ARTIST_OR_COMPOSER:周杰伦
搜索周杰伦的歌曲	MUSIC_SEARCH	ARTIST_OR_COMPOSER:周杰伦
搜索周柏豪的歌曲	MUSIC_SEARCH	ARTIST_OR_COMPOSER:周柏豪
搜索周笔畅的歌曲	MUSIC_SEARCH	ARTIST_OR_COMPOSER:周笔畅
搜索周艳泓的歌曲	MUSIC_SEARCH	ARTIST_OR_COMPOSER:周艳泓
搜索哈狗帮的歌曲	MUSIC_SEARCH	ARTIST_OR_COMPOSER:哈狗帮
搜索唯舞独尊这个专辑	MUSIC_SEARCH	ALBUMNAME:唯舞独尊
搜索喜多村英梨的歌曲	MUSIC_SEARCH	ARTIST_OR_COMPOSER:喜多村英梨
搜索回味的歌手	MUSIC_SEARCH	TITLE:回味
搜索回音哥的歌曲	MUSIC_SEARCH	ARTIST_OR_COMPOSER:回音哥
搜索因你而在这个专辑里面的轻音乐	MUSIC_SEARCH	GENRE:轻音乐	ALBUMNAME:因你而在
搜索垃圾这首歌	MUSIC_SEARCH	TITLE:垃圾
搜索城堡这个专辑	MUSIC_SEARCH	ALBUMNAME:城堡
搜索堀江由衣的歌曲	MUSIC_SEARCH	ARTIST_OR_COMPOSER:堀江由衣
搜索夏天Alex的歌曲	MUSIC_SEARCH	ARTIST_OR_COMPOSER:夏天Alex
搜索多亮的歌曲	MUSIC_SEARCH	ARTIST_OR_COMPOSER:多亮
搜索大冢爱的歌曲	MUSIC_SEARCH	ARTIST_OR_COMPOSER:大冢爱
搜索大哲的歌曲	MUSIC_SEARCH	ARTIST_OR_COMPOSER:大哲
搜索大嘴巴的歌曲	MUSIC_SEARCH	ARTIST_OR_COMPOSER:大嘴巴
搜索大庆小芳的歌曲	MUSIC_SEARCH	ARTIST_OR_COMPOSER:大庆小芳
搜索天下无双的歌手	MUSIC_SEARCH	TITLE:天下无双
搜索天堂飘雪的歌曲	MUSIC_SEARCH	ARTIST_OR_COMPOSER:天堂飘雪
搜索太天真这个专辑里面的轻音乐	MUSIC_SEARCH	GENRE:轻音乐	ALBUMNAME:太天真
搜索央金兰泽的歌曲	MUSIC_SEARCH	ARTIST_OR_COMPOSER:央金兰泽
搜索好久不见这首歌	MUSIC_SEARCH	TITLE:好久不见
搜索好大一棵树的作曲家	MUSIC_SEARCH	TITLE:好大一棵树
搜索好想你这个专辑	MUSIC_SEARCH	ALBUMNAME:好想你
搜索好春天的作曲家	MUSIC_SEARCH	TITLE:好春天
搜索好聚好散这首歌	MUSIC_SEARCH	TITLE:好聚好散
搜索姚笛的歌曲	MUSIC_SEARCH	ARTIST_OR_COMPOSER:姚笛
搜索姜玉阳的歌曲	MUSIC_SEARCH	ARTIST_OR_COMPOSER:姜玉阳
搜索姜育恒的歌曲	MUSIC_SEARCH	ARTIST_OR_COMPOSER:姜育恒
搜索孙楠的歌曲	MUSIC_SEARCH	ARTIST_OR_COMPOSER:孙楠
搜索孙燕姿的歌曲	MUSIC_SEARCH	ARTIST_OR_COMPOSER:孙燕姿
搜索孟庭苇的歌曲	MUSIC_SEARCH	ARTIST_OR_COMPOSER:孟庭苇
搜索宁桓宇的歌曲	MUSIC_SEARCH	ARTIST_OR_COMPOSER:宁桓宇
搜索宇多田光的歌曲	MUSIC_SEARCH	ARTIST_OR_COMPOSER:宇多田光
搜索宇桐非的歌曲	MUSIC_SEARCH	ARTIST_OR_COMPOSER:宇桐非
搜索安与骑兵的歌曲	MUSIC_SEARCH	ARTIST_OR_COMPOSER:安与骑兵
搜索安东阳的歌曲	MUSIC_SEARCH	ARTIST_OR_COMPOSER:安东阳
搜索宋冬野的歌曲	MUSIC_SEARCH	ARTIST_OR_COMPOSER:宋冬野
搜索宗教音乐类型的音乐	MUSIC_SEARCH	GENRE:宗教音乐
搜索家家的歌曲	MUSIC_SEARCH	ARTIST_OR_COMPOSER:家家
搜索容中尔甲的歌曲	MUSIC_SEARCH	ARTIST_OR_COMPOSER:容中尔甲
搜索容祖儿的歌曲	MUSIC_SEARCH	ARTIST_OR_COMPOSER:容祖儿
搜索射手这个专辑里面的轻音乐	MUSIC_SEARCH	GENRE:轻音乐	ALBUMNAME:射手
搜索小仓唯的歌曲	MUSIC_SEARCH	ARTIST_OR_COMPOSER:小仓唯
搜索小山的歌曲	MUSIC_SEARCH	ARTIST_OR_COMPOSER:小山
搜索小峰峰的歌曲	MUSIC_SEARCH	ARTIST_OR_COMPOSER:小峰峰
搜索小恩俊的歌曲	MUSIC_SEARCH	ARTIST_OR_COMPOSER:小恩俊
搜索小曾的歌曲	MUSIC_SEARCH	ARTIST_OR_COMPOSER:小曾
搜索小虎队的歌曲	MUSIC_SEARCH	ARTIST_OR_COMPOSER:小虎队
搜索小贱的歌曲	MUSIC_SEARCH	ARTIST_OR_COMPOSER:小贱
搜索少女时代的歌曲	MUSIC_SEARCH	ARTIST_OR_COMPOSER:少女时代
搜索尚雯婕的歌曲	MUSIC_SEARCH	ARTIST_OR_COMPOSER:尚雯婕
搜索尹美莱的歌曲	MUSIC_SEARCH	ARTIST_OR_COMPOSER:尹美莱
搜索屠洪刚的歌曲	MUSIC_SEARCH	ARTIST_OR_COMPOSER:屠洪刚
搜索山野的歌曲	MUSIC_SEARCH	ARTIST_OR_COMPOSER:山野
搜索崔健的歌曲	MUSIC_SEARCH	ARTIST_OR_COMPOSER:崔健
搜索巫启贤的歌曲	MUSIC_SEARCH	ARTIST_OR_COMPOSER:巫启贤
搜索巴洛克类型的音乐	MUSIC_SEARCH	GENRE:巴洛克
搜索布兰妮的歌曲	MUSIC_SEARCH	ARTIST_OR_COMPOSER:布兰妮
搜索布川的歌曲	MUSIC_SEARCH	ARTIST_OR_COMPOSER:布川
搜索帕瓦罗蒂的歌曲集	MUSIC_SEARCH	ARTIST_OR_COMPOSER:帕瓦罗蒂
搜索常艾非的歌曲	MUSIC_SEARCH	ARTIST_OR_COMPOSER:常艾非
搜索平原绫香的歌曲	MUSIC_SEARCH	ARTIST_OR_COMPOSER:平原绫香
搜索平安的歌曲	MUSIC_SEARCH	ARTIST_OR_COMPOSER:平安
搜索平野绫的歌曲	MUSIC_SEARCH	ARTIST_OR_COMPOSER:平野绫
搜索幸福摩天轮这首歌	MUSIC_SEARCH	TITLE:幸福摩天轮
搜索庄心妍的歌曲	MUSIC_SEARCH	ARTIST_OR_COMPOSER:庄心妍
搜索庞龙的歌曲	MUSIC_SEARCH	ARTIST_OR_COMPOSER:庞龙
搜索开心的音乐	MUSIC_SEARCH	GENRE:开心的音乐
搜索张信哲的歌曲	MUSIC_SEARCH	ARTIST_OR_COMPOSER:张信哲
搜索张冬玲的歌曲	MUSIC_SEARCH	ARTIST_OR_COMPOSER:张冬玲
搜索张卫健的歌曲	MUSIC_SEARCH	ARTIST_OR_COMPOSER:张卫健
搜索张国荣唱过的歌	MUSIC_SEARCH	ARTIST_OR_COMPOSER:张国荣
搜索张国荣的歌曲	MUSIC_SEARCH	ARTIST_OR_COMPOSER:张国荣
搜索张娜拉的歌曲	MUSIC_SEARCH	ARTIST_OR_COMPOSER:张娜拉
搜索张学友的歌曲	MUSIC_SEARCH	ARTIST_OR_COMPOSER:张学友
搜索张惠妹的歌曲	MUSIC_SEARCH	ARTIST_OR_COMPOSER:张惠妹
搜索张振宇的歌曲	MUSIC_SEARCH	ARTIST_OR_COMPOSER:张振宇
搜索张敬轩的歌曲	MUSIC_SEARCH	ARTIST_OR_COMPOSER:张敬轩
搜索张智霖的歌曲	MUSIC_SEARCH	ARTIST_OR_COMPOSER:张智霖
搜索张杰的歌曲	MUSIC_SEARCH	ARTIST_OR_COMPOSER:张杰
搜索张柏芝的歌曲	MUSIC_SEARCH	ARTIST_OR_COMPOSER:张柏芝
搜索张栋梁的歌曲	MUSIC_SEARCH	ARTIST_OR_COMPOSER:张栋梁
搜索张根硕的歌曲	MUSIC_SEARCH	ARTIST_OR_COMPOSER:张根硕
搜索张玮的歌曲	MUSIC_SEARCH	ARTIST_OR_COMPOSER:张玮
搜索张翰的歌曲	MUSIC_SEARCH	ARTIST_OR_COMPOSER:张翰
搜索张芸京的歌曲	MUSIC_SEARCH	ARTIST_OR_COMPOSER:张芸京
搜索张赫宣的歌曲	MUSIC_SEARCH	ARTIST_OR_COMPOSER:张赫宣
搜索张阳阳的歌曲	MUSIC_SEARCH	ARTIST_OR_COMPOSER:张阳阳
搜索张雨生唱的歌曲	MUSIC_SEARCH	ARTIST_OR_COMPOSER:张雨生
搜索张雨生的歌曲	MUSIC_SEARCH	ARTIST_OR_COMPOSER:张雨生
搜索张震岳的歌曲	MUSIC_SEARCH	ARTIST_OR_COMPOSER:张震岳
搜索张靓颖的歌曲	MUSIC_SEARCH	ARTIST_OR_COMPOSER:张靓颖
搜索张韶涵的歌曲	MUSIC_SEARCH	ARTIST_OR_COMPOSER:张韶涵
搜索弦子的歌曲	MUSIC_SEARCH	ARTIST_OR_COMPOSER:弦子
搜索彭佳慧的歌曲	MUSIC_SEARCH	ARTIST_OR_COMPOSER:彭佳慧
搜索影视歌曲	MUSIC_SEARCH	GENRE:影视歌曲
搜索影视金曲	MUSIC_SEARCH	GENRE:影视金曲
搜索徐一鸣的歌曲	MUSIC_SEARCH	ARTIST_OR_COMPOSER:徐一鸣
搜索徐良的歌曲	MUSIC_SEARCH	ARTIST_OR_COMPOSER:徐良
搜索徐若瑄的歌曲	MUSIC_SEARCH	ARTIST_OR_COMPOSER:徐若瑄
搜索徐誉滕的歌曲	MUSIC_SEARCH	ARTIST_OR_COMPOSER:徐誉滕
搜索心经这首歌	MUSIC_SEARCH	TITLE:心经
搜索思小妞的歌曲	MUSIC_SEARCH	ARTIST_OR_COMPOSER:思小妞
搜索想哭这首歌	MUSIC_SEARCH	TITLE:想哭
搜索慕容晓晓的歌曲	MUSIC_SEARCH	ARTIST_OR_COMPOSER:慕容晓晓
搜索成名曲	MUSIC_SEARCH	GENRE:成名曲
搜索成龙的歌	MUSIC_SEARCH	ARTIST_OR_COMPOSER:成龙
搜索成龙的歌曲	MUSIC_SEARCH	ARTIST_OR_COMPOSER:成龙
搜索我是海棠这个专辑	MUSIC_SEARCH	ALBUMNAME:我是海棠
搜索我的歌声里	MUSIC_SEARCH	TITLE:我的歌声里
搜索我终于放开了他这首歌	MUSIC_SEARCH	TITLE:我终于放开了他
搜索我落泪情绪零碎	MUSIC_SEARCH	TITLE:我落泪情绪零碎
搜索戚薇的歌曲	MUSIC_SEARCH	ARTIST_OR_COMPOSER:戚薇
搜索戴佩妮的歌曲	MUSIC_SEARCH	ARTIST_OR_COMPOSER:戴佩妮
搜索戴爱玲的歌曲	MUSIC_SEARCH	ARTIST_OR_COMPOSER:戴爱玲
搜索戸松遥的歌曲	MUSIC_SEARCH	ARTIST_OR_COMPOSER:戸松遥
搜索所有的乡村音乐	MUSIC_SEARCH	GENRE:乡村音乐
搜索所有的民谣	MUSIC_SEARCH	GENRE:民谣
搜索拥抱这分钟	MUSIC_SEARCH	TITLE:拥抱这分钟
搜索搞笑的乐曲	MUSIC_SEARCH	GENRE:搞笑的乐曲
搜索摇尾巴的歌手	MUSIC_SEARCH	TITLE:摇尾巴
搜索摇滚乐	MUSIC_SEARCH	GENRE:摇滚乐
搜索文章的歌曲	MUSIC_SEARCH	ARTIST_OR_COMPOSER:文章
搜索断了的弦	MUSIC_SEARCH	TITLE:断了的弦
搜索斯琴高丽的歌曲	MUSIC_SEARCH	ARTIST_OR_COMPOSER:斯琴高丽
搜索新不了情这首歌曲	MUSIC_SEARCH	TITLE:新不了情
搜索新垣结衣的歌曲	MUSIC_SEARCH	ARTIST_OR_COMPOSER:新垣结衣
搜索方力申的歌曲	MUSIC_SEARCH	ARTIST_OR_COMPOSER:方力申
搜索方大同的歌曲	MUSIC_SEARCH	ARTIST_OR_COMPOSER:方大同
搜索无限之城	MUSIC_SEARCH	TITLE:无限之城
搜索日笠阳子的歌曲	MUSIC_SEARCH	ARTIST_OR_COMPOSER:日笠阳子
搜索易欣的歌曲	MUSIC_SEARCH	ARTIST_OR_COMPOSER:易欣
搜索星弟的歌曲	MUSIC_SEARCH	ARTIST_OR_COMPOSER:星弟
搜索星晴	MUSIC_SEARCH	TITLE:星晴
搜索暂存这张专辑	MUSIC_SEARCH	ALBUMNAME:暂存
搜索曲婉婷的歌	MUSIC_SEARCH	ARTIST_OR_COMPOSER:曲婉婷
搜索曲婉婷的歌曲	MUSIC_SEARCH	ARTIST_OR_COMPOSER:曲婉婷
搜索曹格的歌曲	MUSIC_SEARCH	ARTIST_OR_COMPOSER:曹格
搜索曹轩宾的歌曲	MUSIC_SEARCH	ARTIST_OR_COMPOSER:曹轩宾
搜索曾一鸣的歌曲	MUSIC_SEARCH	ARTIST_OR_COMPOSER:曾一鸣
搜索曾春年的歌曲	MUSIC_SEARCH	ARTIST_OR_COMPOSER:曾春年
搜索曾沛慈的歌曲	MUSIC_SEARCH	ARTIST_OR_COMPOSER:曾沛慈
搜索曾轶可的歌曲	MUSIC_SEARCH	ARTIST_OR_COMPOSER:曾轶可
搜索最后派对这首歌	MUSIC_SEARCH	TITLE:最后派对
搜索最长的电影	MUSIC_SEARCH	TITLE:最长的电影
搜索月亮代表我的心的作曲家	MUSIC_SEARCH	TITLE:月亮代表我的心
搜索有中国风的音乐	MUSIC_SEARCH	GENRE:中国风
搜索李代沫的歌曲	MUSIC_SEARCH	ARTIST_OR_COMPOSER:李代沫
搜索李佳薇的歌曲	MUSIC_SEARCH	ARTIST_OR_COMPOSER:李佳薇
搜索李圣杰的歌曲	MUSIC_SEARCH	ARTIST_OR_COMPOSER:李圣杰
搜索李娜的歌曲	MUSIC_SEARCH	ARTIST_OR_COMPOSER:李娜
搜索李孝利的歌曲	MUSIC_SEARCH	ARTIST_OR_COMPOSER:李孝利
搜索李宇春的歌曲	MUSIC_SEARCH	ARTIST_OR_COMPOSER:李宇春
搜索李宗盛的歌曲	MUSIC_SEARCH	ARTIST_OR_COMPOSER:李宗盛
搜索李慧珍的歌曲	MUSIC_SEARCH	ARTIST_OR_COMPOSER:李慧珍
搜索李晓杰的歌曲	MUSIC_SEARCH	ARTIST_OR_COMPOSER:李晓杰
搜索李治廷的歌曲	MUSIC_SEARCH	ARTIST_OR_COMPOSER:李治廷
搜索李玉刚的歌曲	MUSIC_SEARCH	ARTIST_OR_COMPOSER:李玉刚
搜索李玖哲的歌曲	MUSIC_SEARCH	ARTIST_OR_COMPOSER:李玖哲
搜索李玟的歌曲	MUSIC_SEARCH	ARTIST_OR_COMPOSER:李玟
搜索李的歌曲	MUSIC_SEARCH	ARTIST_OR_COMPOSER:李
搜索李翊君的歌曲	MUSIC_SEARCH	ARTIST_OR_COMPOSER:李翊君
搜索李行亮的歌曲	MUSIC_SEARCH	ARTIST_OR_COMPOSER:李行亮
搜索李贞贤的歌曲	MUSIC_SEARCH	ARTIST_OR_COMPOSER:李贞贤
搜索杜德伟的歌曲	MUSIC_SEARCH	ARTIST_OR_COMPOSER:杜德伟
搜索杜歌的歌曲	MUSIC_SEARCH	ARTIST_OR_COMPOSER:杜歌
搜索杨丞琳的歌曲	MUSIC_SEARCH	ARTIST_OR_COMPOSER:杨丞琳
搜索杨千嬅的歌曲	MUSIC_SEARCH	ARTIST_OR_COMPOSER:杨千嬅
搜索杨培安的歌曲	MUSIC_SEARCH	ARTIST_OR_COMPOSER:杨培安
搜索杨宗纬的歌曲	MUSIC_SEARCH	ARTIST_OR_COMPOSER:杨宗纬
搜索杨幂的歌曲	MUSIC_SEARCH	ARTIST_OR_COMPOSER:杨幂
搜索杨钰莹的歌曲	MUSIC_SEARCH	ARTIST_OR_COMPOSER:杨钰莹
搜索林俊杰的歌曲	MUSIC_SEARCH	ARTIST_OR_COMPOSER:林俊杰
搜索林凡的歌曲	MUSIC_SEARCH	ARTIST_OR_COMPOSER:林凡
搜索林子祥的歌曲	MUSIC_SEARCH	ARTIST_OR_COMPOSER:林子祥
搜索林宥嘉的歌曲	MUSIC_SEARCH	ARTIST_OR_COMPOSER:林宥嘉
搜索林心如的歌曲	MUSIC_SEARCH	ARTIST_OR_COMPOSER:林心如
搜索林忆莲的歌曲	MUSIC_SEARCH	ARTIST_OR_COMPOSER:林忆莲
搜索林志炫的歌曲	MUSIC_SEARCH	ARTIST_OR_COMPOSER:林志炫
搜索林志颖的歌曲	MUSIC_SEARCH	ARTIST_OR_COMPOSER:林志颖
搜索林政熙的歌曲	MUSIC_SEARCH	ARTIST_OR_COMPOSER:林政熙
搜索梁博的歌曲	MUSIC_SEARCH	ARTIST_OR_COMPOSER:梁博
搜索梁咏琪的歌曲	MUSIC_SEARCH	ARTIST_OR_COMPOSER:梁咏琪
搜索梁文音的歌曲	MUSIC_SEARCH	ARTIST_OR_COMPOSER:梁文音
搜索梁汉文的歌曲	MUSIC_SEARCH	ARTIST_OR_COMPOSER:梁汉文
搜索梁静茹的歌曲	MUSIC_SEARCH	ARTIST_OR_COMPOSER:梁静茹
搜索梅艳芳的歌曲	MUSIC_SEARCH	ARTIST_OR_COMPOSER:梅艳芳
搜索梦泡类型的音乐	MUSIC_SEARCH	GENRE:梦泡
搜索欢子的歌曲	MUSIC_SEARCH	ARTIST_OR_COMPOSER:欢子
搜索欧豪的歌曲	MUSIC_SEARCH	ARTIST_OR_COMPOSER:欧豪
搜索歌曲一不小心爱上你	MUSIC_SEARCH	TITLE:一不小心爱上你
搜索歌曲一丝不挂	MUSIC_SEARCH	TITLE:一丝不挂
搜索歌曲一千年以后	MUSIC_SEARCH	TITLE:一千年以后
搜索歌曲七年	MUSIC_SEARCH	TITLE:七年
搜索歌曲上机前一秒	MUSIC_SEARCH	TITLE:上机前一秒
搜索歌曲不如不见	MUSIC_SEARCH	TITLE:不如不见
搜索歌曲不要说话	MUSIC_SEARCH	TITLE:不要说话
搜索歌曲两个人的世界	MUSIC_SEARCH	TITLE:两个人的世界
搜索歌曲两边	MUSIC_SEARCH	TITLE:两边
搜索歌曲主旋律	MUSIC_SEARCH	TITLE:主旋律
搜索歌曲义勇军进行曲	MUSIC_SEARCH	TITLE:义勇军进行曲
搜索歌曲于心有愧	MUSIC_SEARCH	TITLE:于心有愧
搜索歌曲人人爱	MUSIC_SEARCH	TITLE:人人爱
搜索歌曲任我行	MUSIC_SEARCH	TITLE:任我行
搜索歌曲传说	MUSIC_SEARCH	TITLE:传说
搜索歌曲伤信	MUSIC_SEARCH	TITLE:伤信
搜索歌曲伤心证明书	MUSIC_SEARCH	TITLE:伤心证明书
搜索歌曲你和我和他之间	MUSIC_SEARCH	TITLE:你和我和他之间
搜索歌曲你最珍贵	MUSIC_SEARCH	TITLE:你最珍贵
搜索歌曲你的承诺	MUSIC_SEARCH	TITLE:你的承诺
搜索歌曲你的眼睛	MUSIC_SEARCH	TITLE:你的眼睛
搜索歌曲你的背包	MUSIC_SEARCH	TITLE:你的背包
搜索歌曲依然范特西	MUSIC_SEARCH	ALBUMNAME:依然范特西
搜索歌曲信徒	MUSIC_SEARCH	TITLE:信徒
搜索歌曲倒带人生	MUSIC_SEARCH	TITLE:倒带人生
搜索歌曲做你的一半	MUSIC_SEARCH	TITLE:做你的一半
搜索歌曲傻瓜	MUSIC_SEARCH	TITLE:傻瓜
搜索歌曲光辉岁月	MUSIC_SEARCH	TITLE:光辉岁月
搜索歌曲全世界失眠	MUSIC_SEARCH	TITLE:全世界失眠
搜索歌曲全城热恋	MUSIC_SEARCH	TITLE:全城热恋
搜索歌曲内疚	MUSIC_SEARCH	TITLE:内疚
搜索歌曲再见北极雪	MUSIC_SEARCH	TITLE:再见北极雪
搜索歌曲出乎意料	MUSIC_SEARCH	TITLE:出乎意料
搜索歌曲分手的恋爱	MUSIC_SEARCH	TITLE:分手的恋爱
搜索歌曲刻不容缓	MUSIC_SEARCH	TITLE:刻不容缓
搜索歌曲十年	MUSIC_SEARCH	TITLE:十年
搜索歌曲半生熟	MUSIC_SEARCH	TITLE:半生熟
搜索歌曲发现爱	MUSIC_SEARCH	TITLE:发现爱
搜索歌曲只能抱着你	MUSIC_SEARCH	TITLE:只能抱着你
搜索歌曲只要有你	MUSIC_SEARCH	TITLE:只要有你
搜索歌曲可不可以	MUSIC_SEARCH	TITLE:可不可以
搜索歌曲叶惠美	MUSIC_SEARCH	ALBUMNAME:叶惠美
搜索歌曲合久必婚	MUSIC_SEARCH	TITLE:合久必婚
搜索歌曲合唱歌	MUSIC_SEARCH	TITLE:合唱歌
搜索歌曲吟游诗人	MUSIC_SEARCH	TITLE:吟游诗人
搜索歌曲告别娑婆	MUSIC_SEARCH	TITLE:告别娑婆
搜索歌曲固定伴侣	MUSIC_SEARCH	TITLE:固定伴侣
搜索歌曲在我生命中的每一天	MUSIC_SEARCH	TITLE:在我生命中的每一天
搜索歌曲复刻回忆	MUSIC_SEARCH	TITLE:复刻回忆
搜索歌曲外滩十八号	MUSIC_SEARCH	TITLE:外滩十八号
搜索歌曲天下有情人	MUSIC_SEARCH	TITLE:天下有情人
搜索歌曲天生一对	MUSIC_SEARCH	TITLE:天生一对
搜索歌曲天生注定	MUSIC_SEARCH	TITLE:天生注定
搜索歌曲失忆蝴蝶	MUSIC_SEARCH	TITLE:失忆蝴蝶
搜索歌曲奇妙的约会	MUSIC_SEARCH	TITLE:奇妙的约会
搜索歌曲好好恋爱	MUSIC_SEARCH	TITLE:好好恋爱
搜索歌曲婚礼的祝福	MUSIC_SEARCH	TITLE:婚礼的祝福
搜索歌曲孤独患者	MUSIC_SEARCH	TITLE:孤独患者
搜索歌曲小夫妻	MUSIC_SEARCH	TITLE:小夫妻
搜索歌曲屋顶	MUSIC_SEARCH	TITLE:屋顶
搜索歌曲希望你会懂	MUSIC_SEARCH	TITLE:希望你会懂
搜索歌曲广岛之恋	MUSIC_SEARCH	TITLE:广岛之恋
搜索歌曲床头床尾	MUSIC_SEARCH	TITLE:床头床尾
搜索歌曲当爱已成往事	MUSIC_SEARCH	TITLE:当爱已成往事
搜索歌曲心动心痛	MUSIC_SEARCH	TITLE:心动心痛
搜索歌曲心愿便利贴	MUSIC_SEARCH	TITLE:心愿便利贴
搜索歌曲恋爱令人心痛	MUSIC_SEARCH	TITLE:恋爱令人心痛
搜索歌曲恋爱达人	MUSIC_SEARCH	TITLE:恋爱达人
搜索歌曲恋爱频率	MUSIC_SEARCH	TITLE:恋爱频率
搜索歌曲情圣	MUSIC_SEARCH	TITLE:情圣
搜索歌曲我想更懂你	MUSIC_SEARCH	TITLE:我想更懂你
搜索歌曲我的歌声里	MUSIC_SEARCH	TITLE:我的歌声里
搜索歌曲挥着翅膀的女孩	MUSIC_SEARCH	TITLE:挥着翅膀的女孩
搜索歌曲掏空	MUSIC_SEARCH	TITLE:掏空
搜索歌曲斯德哥尔摩情人	MUSIC_SEARCH	TITLE:斯德哥尔摩情人
搜索歌曲时光倒流二十年	MUSIC_SEARCH	TITLE:时光倒流二十年
搜索歌曲明天以后	MUSIC_SEARCH	TITLE:明天以后
搜索歌曲明年今日	MUSIC_SEARCH	TITLE:明年今日
搜索歌曲最佳损友	MUSIC_SEARCH	TITLE:最佳损友
搜索歌曲有一点动心	MUSIC_SEARCH	TITLE:有一点动心
搜索歌曲有心	MUSIC_SEARCH	TITLE:有心
搜索歌曲有梦好甜蜜	MUSIC_SEARCH	TITLE:有梦好甜蜜
搜索歌曲有缘千里	MUSIC_SEARCH	TITLE:有缘千里
搜索歌曲梦想天空分外蓝	MUSIC_SEARCH	TITLE:梦想天空分外蓝
搜索歌曲每个爱情都危险	MUSIC_SEARCH	TITLE:每个爱情都危险
搜索歌曲水晶	MUSIC_SEARCH	TITLE:水晶
搜索歌曲浮夸	MUSIC_SEARCH	TITLE:浮夸
搜索歌曲淘汰	MUSIC_SEARCH	TITLE:淘汰
搜索歌曲深爱相拥	MUSIC_SEARCH	TITLE:深爱相拥
搜索歌曲漂流瓶	MUSIC_SEARCH	TITLE:漂流瓶
搜索歌曲爱作梦的鱼	MUSIC_SEARCH	TITLE:爱作梦的鱼
搜索歌曲爱和承诺	MUSIC_SEARCH	TITLE:爱和承诺
搜索歌曲爱的主旋律	MUSIC_SEARCH	TITLE:爱的主旋律
搜索歌曲爱的天使	MUSIC_SEARCH	TITLE:爱的天使
搜索歌曲独唱情歌	MUSIC_SEARCH	TITLE:独唱情歌
搜索歌曲理智与感情	MUSIC_SEARCH	TITLE:理智与感情
搜索歌曲画纸上的戒指	MUSIC_SEARCH	TITLE:画纸上的戒指
搜索歌曲痛	MUSIC_SEARCH	TITLE:痛
搜索歌曲痛苦过	MUSIC_SEARCH	TITLE:痛苦过
搜索歌曲相思风雨中	MUSIC_SEARCH	TITLE:相思风雨中
搜索歌曲相爱多年	MUSIC_SEARCH	TITLE:相爱多年
搜索歌曲相爱很难	MUSIC_SEARCH	TITLE:相爱很难
搜索歌曲相约到永久	MUSIC_SEARCH	TITLE:相约到永久
搜索歌曲真爱在明天	MUSIC_SEARCH	TITLE:真爱在明天
搜索歌曲碌卡	MUSIC_SEARCH	TITLE:碌卡
搜索歌曲祈祷	MUSIC_SEARCH	TITLE:祈祷
搜索歌曲积木	MUSIC_SEARCH	TITLE:积木
搜索歌曲突然想爱你	MUSIC_SEARCH	TITLE:突然想爱你
搜索歌曲窗外	MUSIC_SEARCH	TITLE:窗外
搜索歌曲约定	MUSIC_SEARCH	TITLE:约定
搜索歌曲细数	MUSIC_SEARCH	TITLE:细数
搜索歌曲经过	MUSIC_SEARCH	TITLE:经过
搜索歌曲绯闻男女	MUSIC_SEARCH	TITLE:绯闻男女
搜索歌曲老人与海	MUSIC_SEARCH	TITLE:老人与海
搜索歌曲董小姐	MUSIC_SEARCH	TITLE:董小姐
搜索歌曲蓝色频闪灯	MUSIC_SEARCH	TITLE:蓝色频闪灯
搜索歌曲被风吹过的夏天	MUSIC_SEARCH	TITLE:被风吹过的夏天
搜索歌曲让我爱你	MUSIC_SEARCH	TITLE:让我爱你
搜索歌曲让梦冬眠	MUSIC_SEARCH	TITLE:让梦冬眠
搜索歌曲记忆	MUSIC_SEARCH	TITLE:记忆
搜索歌曲许愿	MUSIC_SEARCH	TITLE:许愿
搜索歌曲请跟我来	MUSIC_SEARCH	TITLE:请跟我来
搜索歌曲走火入魔	MUSIC_SEARCH	TITLE:走火入魔
搜索歌曲还要不要走	MUSIC_SEARCH	TITLE:还要不要走
搜索歌曲进行式	MUSIC_SEARCH	TITLE:进行式
搜索歌曲远在咫尺	MUSIC_SEARCH	TITLE:远在咫尺
搜索歌曲选择	MUSIC_SEARCH	TITLE:选择
搜索歌曲遥远的她	MUSIC_SEARCH	TITLE:遥远的她
搜索歌曲那些年	MUSIC_SEARCH	TITLE:那些年
搜索歌曲重口味	MUSIC_SEARCH	TITLE:重口味
搜索歌曲长流不息	MUSIC_SEARCH	TITLE:长流不息
搜索歌曲阿猫阿狗	MUSIC_SEARCH	TITLE:阿猫阿狗
搜索歌曲难以抗拒	MUSIC_SEARCH	TITLE:难以抗拒
搜索歌曲非常完美	MUSIC_SEARCH	TITLE:非常完美
搜索歌曲非礼	MUSIC_SEARCH	TITLE:非礼
搜索歌曲预感	MUSIC_SEARCH	TITLE:预感
搜索歌曲黑糖秀	MUSIC_SEARCH	TITLE:黑糖秀
搜索歌浴森的歌曲	MUSIC_SEARCH	ARTIST_OR_COMPOSER:歌浴森
搜索止战之殇	MUSIC_SEARCH	TITLE:止战之殇
搜索武艺的歌曲	MUSIC_SEARCH	ARTIST_OR_COMPOSER:武艺
搜索毛宁的歌曲	MUSIC_SEARCH	ARTIST_OR_COMPOSER:毛宁
搜索水手怕水	MUSIC_SEARCH	TITLE:水手怕水
搜索水木年华的歌曲	MUSIC_SEARCH	ARTIST_OR_COMPOSER:水木年华
搜索水树奈奈的歌曲	MUSIC_SEARCH	ARTIST_OR_COMPOSER:水树奈奈
搜索江映蓉的歌曲	MUSIC_SEARCH	ARTIST_OR_COMPOSER:江映蓉
搜索江智民的歌曲	MUSIC_SEARCH	ARTIST_OR_COMPOSER:江智民
搜索江美琪的歌曲	MUSIC_SEARCH	ARTIST_OR_COMPOSER:江美琪
搜索江语晨的歌曲	MUSIC_SEARCH	ARTIST_OR_COMPOSER:江语晨
搜索汤潮的歌曲	MUSIC_SEARCH	ARTIST_OR_COMPOSER:汤潮
搜索汪东城的歌曲	MUSIC_SEARCH	ARTIST_OR_COMPOSER:汪东城
搜索汪峰的歌曲	MUSIC_SEARCH	ARTIST_OR_COMPOSER:汪峰
搜索汪苏泷的歌曲	MUSIC_SEARCH	ARTIST_OR_COMPOSER:汪苏泷
搜索沙宝亮的歌曲	MUSIC_SEARCH	ARTIST_OR_COMPOSER:沙宝亮
搜索河图的歌曲	MUSIC_SEARCH	ARTIST_OR_COMPOSER:河图
搜索泳儿张悬的歌曲	MUSIC_SEARCH	ARTIST_OR_COMPOSER:泳儿张悬
搜索浪漫主义音乐类型的音乐	MUSIC_SEARCH	GENRE:浪漫主义音乐
搜索海鸣威的歌曲	MUSIC_SEARCH	ARTIST_OR_COMPOSER:海鸣威
搜索清唱类型的音乐	MUSIC_SEARCH	GENRE:清唱
搜索温岚的歌曲	MUSIC_SEARCH	ARTIST_OR_COMPOSER:温岚
搜索游鸿明的歌曲	MUSIC_SEARCH	ARTIST_OR_COMPOSER:游鸿明
搜索潘广益的歌曲	MUSIC_SEARCH	ARTIST_OR_COMPOSER:潘广益
搜索潘玮柏的歌曲	MUSIC_SEARCH	ARTIST_OR_COMPOSER:潘玮柏
搜索潘美辰的歌曲	MUSIC_SEARCH	ARTIST_OR_COMPOSER:潘美辰
搜索火力全开这张专辑	MUSIC_SEARCH	ALBUMNAME:火力全开
搜索炎亚纶的歌曲	MUSIC_SEARCH	ARTIST_OR_COMPOSER:炎亚纶
搜索然后怎样这首歌	MUSIC_SEARCH	TITLE:然后怎样
搜索爱在公元前	MUSIC_SEARCH	TITLE:爱在公元前
搜索爱情转移这首歌	MUSIC_SEARCH	TITLE:爱情转移
搜索爱的练习语这个专辑	MUSIC_SEARCH	ALBUMNAME:爱的练习语
搜索爵士乐	MUSIC_SEARCH	GENRE:爵士乐
搜索爵士音乐类型的音乐	MUSIC_SEARCH	GENRE:爵士音乐
搜索爷爷泡的茶	MUSIC_SEARCH	TITLE:爷爷泡的茶
搜索牙牙乐的歌曲	MUSIC_SEARCH	ARTIST_OR_COMPOSER:牙牙乐
搜索牛仔很忙	MUSIC_SEARCH	TITLE:牛仔很忙
搜索牛仔很忙这个歌曲	MUSIC_SEARCH	TITLE:牛仔很忙
搜索牛仔很忙这首歌	MUSIC_SEARCH	TITLE:牛仔很忙
搜索牛奶咖啡的歌曲	MUSIC_SEARCH	ARTIST_OR_COMPOSER:牛奶咖啡
搜索王媛渊的歌曲	MUSIC_SEARCH	ARTIST_OR_COMPOSER:王媛渊
搜索王强的歌曲	MUSIC_SEARCH	ARTIST_OR_COMPOSER:王强
搜索王心凌的歌	MUSIC_SEARCH	ARTIST_OR_COMPOSER:王心凌
搜索王心凌的歌曲	MUSIC_SEARCH	ARTIST_OR_COMPOSER:王心凌
搜索王筝的歌曲	MUSIC_SEARCH	ARTIST_OR_COMPOSER:王筝
搜索王绎龙的歌曲	MUSIC_SEARCH	ARTIST_OR_COMPOSER:王绎龙
搜索王若琳的歌曲	MUSIC_SEARCH	ARTIST_OR_COMPOSER:王若琳
搜索王菀之的歌曲	MUSIC_SEARCH	ARTIST_OR_COMPOSER:王菀之
搜索王菲的歌曲	MUSIC_SEARCH	ARTIST_OR_COMPOSER:王菲
搜索王蓉的歌曲	MUSIC_SEARCH	ARTIST_OR_COMPOSER:王蓉
搜索王露凝的歌曲	MUSIC_SEARCH	ARTIST_OR_COMPOSER:王露凝
搜索王麟的歌曲	MUSIC_SEARCH	ARTIST_OR_COMPOSER:王麟
搜索玖月奇迹的歌曲	MUSIC_SEARCH	ARTIST_OR_COMPOSER:玖月奇迹
搜索班德瑞的歌曲	MUSIC_SEARCH	ARTIST_OR_COMPOSER:班德瑞
搜索甜甜的	MUSIC_SEARCH	TITLE:甜甜的
搜索生存以上生活以下的歌曲信息	MUSIC_SEARCH	TITLE:生存以上生活以下
搜索田一龙的歌曲	MUSIC_SEARCH	ARTIST_OR_COMPOSER:田一龙
搜索田震的歌曲	MUSIC_SEARCH	ARTIST_OR_COMPOSER:田震
搜索田馥甄的歌曲	MUSIC_SEARCH	ARTIST_OR_COMPOSER:田馥甄
搜索白举纲的歌曲	MUSIC_SEARCH	ARTIST_OR_COMPOSER:白举纲
搜索白智英的歌曲	MUSIC_SEARCH	ARTIST_OR_COMPOSER:白智英
搜索白玫瑰这首歌	MUSIC_SEARCH	TITLE:白玫瑰
搜索的范玮琪的歌曲	MUSIC_SEARCH	ARTIST_OR_COMPOSER:范玮琪
搜索的许佳慧的歌曲	MUSIC_SEARCH	ARTIST_OR_COMPOSER:许佳慧
搜索看我72变这个专辑	MUSIC_SEARCH	ALBUMNAME:看我72变
搜索看我七十二变	MUSIC_SEARCH	TITLE:看我七十二变
搜索看我七十二变是谁唱的	MUSIC_SEARCH	TITLE:看我七十二变
搜索石梅的歌曲	MUSIC_SEARCH	ARTIST_OR_COMPOSER:石梅
搜索石进的歌曲	MUSIC_SEARCH	ARTIST_OR_COMPOSER:石进
搜索神奇化妆师这首歌	MUSIC_SEARCH	TITLE:神奇化妆师
搜索神木与瞳的歌曲	MUSIC_SEARCH	ARTIST_OR_COMPOSER:神木与瞳
搜索程响的歌曲	MUSIC_SEARCH	ARTIST_OR_COMPOSER:程响
搜索童安格的歌曲	MUSIC_SEARCH	ARTIST_OR_COMPOSER:童安格
搜索竹达彩奈的歌曲	MUSIC_SEARCH	ARTIST_OR_COMPOSER:竹达彩奈
搜索笑与哭的歌曲信息	MUSIC_SEARCH	TITLE:笑与哭
搜索等这首歌	MUSIC_SEARCH	TITLE:等
搜索筷子兄弟的歌曲	MUSIC_SEARCH	ARTIST_OR_COMPOSER:筷子兄弟
搜索简单爱	MUSIC_SEARCH	TITLE:简单爱
搜索精彩这首歌	MUSIC_SEARCH	TITLE:精彩
搜索糖糖乐团的歌曲	MUSIC_SEARCH	ARTIST_OR_COMPOSER:糖糖乐团
搜索纪晓斌的歌曲	MUSIC_SEARCH	ARTIST_OR_COMPOSER:纪晓斌
搜索纯属意外这张专辑	MUSIC_SEARCH	ALBUMNAME:纯属意外
搜索给我一首歌的时间	MUSIC_SEARCH	TITLE:给我一首歌的时间
搜索罗大佑的歌曲	MUSIC_SEARCH	ARTIST_OR_COMPOSER:罗大佑
搜索罗志祥的歌曲	MUSIC_SEARCH	ARTIST_OR_COMPOSER:罗志祥
搜索罗百吉的歌曲	MUSIC_SEARCH	ARTIST_OR_COMPOSER:罗百吉
搜索羽泉的歌曲	MUSIC_SEARCH	ARTIST_OR_COMPOSER:羽泉
搜索胜利的歌曲	MUSIC_SEARCH	ARTIST_OR_COMPOSER:胜利
搜索胡夏的歌曲	MUSIC_SEARCH	ARTIST_OR_COMPOSER:胡夏
搜索胡彦斌的歌曲	MUSIC_SEARCH	ARTIST_OR_COMPOSER:胡彦斌
搜索胡杨林的歌曲	MUSIC_SEARCH	ARTIST_OR_COMPOSER:胡杨林
搜索胡歌的歌曲	MUSIC_SEARCH	ARTIST_OR_COMPOSER:胡歌
搜索至上励合的歌曲	MUSIC_SEARCH	ARTIST_OR_COMPOSER:至上励合
搜索舞娘这个专辑	MUSIC_SEARCH	ALBUMNAME:舞娘
搜索舞曲类型的音乐	MUSIC_SEARCH	GENRE:舞曲
搜索艾薇儿的歌曲	MUSIC_SEARCH	ARTIST_OR_COMPOSER:艾薇儿
搜索花花世界这首歌	MUSIC_SEARCH	TITLE:花花世界
搜索花蝴蝶这个专辑	MUSIC_SEARCH	ALBUMNAME:花蝴蝶
搜索苏仨的歌曲	MUSIC_SEARCH	ARTIST_OR_COMPOSER:苏仨
搜索苏打绿的歌曲	MUSIC_SEARCH	ARTIST_OR_COMPOSER:苏打绿
搜索苏永康的歌曲	MUSIC_SEARCH	ARTIST_OR_COMPOSER:苏永康
搜索苏芮的歌曲	MUSIC_SEARCH	ARTIST_OR_COMPOSER:苏芮
搜索范晓萱的歌曲	MUSIC_SEARCH	ARTIST_OR_COMPOSER:范晓萱
搜索范特西	MUSIC_SEARCH	ALBUMNAME:范特西
搜索范特西这个专辑	MUSIC_SEARCH	ALBUMNAME:范特西
搜索范逸臣的歌曲	MUSIC_SEARCH	ARTIST_OR_COMPOSER:范逸臣
搜索茅原实里的歌曲	MUSIC_SEARCH	ARTIST_OR_COMPOSER:茅原实里
搜索茅野爱衣的歌曲	MUSIC_SEARCH	ARTIST_OR_COMPOSER:茅野爱衣
搜索草蜢的歌曲	MUSIC_SEARCH	ARTIST_OR_COMPOSER:草蜢
搜索莫小娘的歌曲	MUSIC_SEARCH	ARTIST_OR_COMPOSER:莫小娘
搜索莫文蔚的歌曲	MUSIC_SEARCH	ARTIST_OR_COMPOSER:莫文蔚
搜索菅野洋子的歌曲	MUSIC_SEARCH	ARTIST_OR_COMPOSER:菅野洋子
搜索菊花台	MUSIC_SEARCH	TITLE:菊花台
搜索萧亚轩的歌曲	MUSIC_SEARCH	ARTIST_OR_COMPOSER:萧亚轩
搜索萧敬腾的歌曲	MUSIC_SEARCH	ARTIST_OR_COMPOSER:萧敬腾
搜索萧萧的歌曲	MUSIC_SEARCH	ARTIST_OR_COMPOSER:萧萧
搜索萨顶顶的歌曲	MUSIC_SEARCH	ARTIST_OR_COMPOSER:萨顶顶
搜索董贞的歌曲	MUSIC_SEARCH	ARTIST_OR_COMPOSER:董贞
搜索蒋雪儿的歌曲	MUSIC_SEARCH	ARTIST_OR_COMPOSER:蒋雪儿
搜索蒙面哥的歌曲	MUSIC_SEARCH	ARTIST_OR_COMPOSER:蒙面哥
搜索蒲公英的约定	MUSIC_SEARCH	TITLE:蒲公英的约定
搜索蓝又时的歌曲	MUSIC_SEARCH	ARTIST_OR_COMPOSER:蓝又时
搜索蓝琪儿的歌曲	MUSIC_SEARCH	ARTIST_OR_COMPOSER:蓝琪儿
搜索蓝雨的歌曲	MUSIC_SEARCH	ARTIST_OR_COMPOSER:蓝雨
搜索蔡健雅的歌曲	MUSIC_SEARCH	ARTIST_OR_COMPOSER:蔡健雅
搜索蔡卓妍的歌曲	MUSIC_SEARCH	ARTIST_OR_COMPOSER:蔡卓妍
搜索蔡妍的歌曲	MUSIC_SEARCH	ARTIST_OR_COMPOSER:蔡妍
搜索蔡旻佑的歌曲	MUSIC_SEARCH	ARTIST_OR_COMPOSER:蔡旻佑
搜索蔡淳佳的歌曲	MUSIC_SEARCH	ARTIST_OR_COMPOSER:蔡淳佳
搜索蔡琴的歌曲	MUSIC_SEARCH	ARTIST_OR_COMPOSER:蔡琴
搜索薛之谦的歌曲	MUSIC_SEARCH	ARTIST_OR_COMPOSER:薛之谦
搜索薛凯琪的歌曲	MUSIC_SEARCH	ARTIST_OR_COMPOSER:薛凯琪
搜索虞姬的歌曲	MUSIC_SEARCH	ARTIST_OR_COMPOSER:虞姬
搜索袁成杰的歌曲	MUSIC_SEARCH	ARTIST_OR_COMPOSER:袁成杰
搜索裘海正的歌曲	MUSIC_SEARCH	ARTIST_OR_COMPOSER:裘海正
搜索裙下之臣这首歌	MUSIC_SEARCH	TITLE:裙下之臣
搜索西野加奈的歌曲	MUSIC_SEARCH	ARTIST_OR_COMPOSER:西野加奈
搜索言承旭的歌曲	MUSIC_SEARCH	ARTIST_OR_COMPOSER:言承旭
搜索让爱作主的歌手	MUSIC_SEARCH	TITLE:让爱作主
搜索许冠杰的歌曲	MUSIC_SEARCH	ARTIST_OR_COMPOSER:许冠杰
搜索许嵩的歌曲	MUSIC_SEARCH	ARTIST_OR_COMPOSER:许嵩
搜索许志安的歌曲	MUSIC_SEARCH	ARTIST_OR_COMPOSER:许志安
搜索许慧欣的歌曲	MUSIC_SEARCH	ARTIST_OR_COMPOSER:许慧欣
搜索许美静的歌曲	MUSIC_SEARCH	ARTIST_OR_COMPOSER:许美静
搜索许艺娜的歌曲	MUSIC_SEARCH	ARTIST_OR_COMPOSER:许艺娜
搜索许茹芸的歌曲	MUSIC_SEARCH	ARTIST_OR_COMPOSER:许茹芸
搜索许飞的歌曲	MUSIC_SEARCH	ARTIST_OR_COMPOSER:许飞
搜索说了再见	MUSIC_SEARCH	TITLE:说了再见
搜索说好的幸福呢	MUSIC_SEARCH	TITLE:说好的幸福呢
搜索谢军的歌曲	MUSIC_SEARCH	ARTIST_OR_COMPOSER:谢军
搜索谢安琪的歌曲	MUSIC_SEARCH	ARTIST_OR_COMPOSER:谢安琪
搜索谢容儿的歌曲	MUSIC_SEARCH	ARTIST_OR_COMPOSER:谢容儿
搜索谢谢侬这首歌	MUSIC_SEARCH	TITLE:谢谢侬
搜索谢霆锋的歌曲	MUSIC_SEARCH	ARTIST_OR_COMPOSER:谢霆锋
搜索谭咏麟的歌曲	MUSIC_SEARCH	ARTIST_OR_COMPOSER:谭咏麟
搜索贯诗钦的歌曲	MUSIC_SEARCH	ARTIST_OR_COMPOSER:贯诗钦
搜索费玉清的歌曲	MUSIC_SEARCH	ARTIST_OR_COMPOSER:费玉清
搜索贺一航的歌曲	MUSIC_SEARCH	ARTIST_OR_COMPOSER:贺一航
搜索贾盛强的歌曲	MUSIC_SEARCH	ARTIST_OR_COMPOSER:贾盛强
搜索赵传的歌曲	MUSIC_SEARCH	ARTIST_OR_COMPOSER:赵传
搜索赵薇的歌曲	MUSIC_SEARCH	ARTIST_OR_COMPOSER:赵薇
搜索超错这首歌	MUSIC_SEARCH	TITLE:超错
搜索跨时代这个专辑	MUSIC_SEARCH	ALBUMNAME:跨时代
搜索轻音乐类型的音乐	MUSIC_SEARCH	GENRE:轻音乐
搜索辛晓琪的歌曲	MUSIC_SEARCH	ARTIST_OR_COMPOSER:辛晓琪
搜索这句话这首歌	MUSIC_SEARCH	TITLE:这句话
搜索迟志强的歌曲	MUSIC_SEARCH	ARTIST_OR_COMPOSER:迟志强
搜索迪克牛仔的歌曲	MUSIC_SEARCH	ARTIST_OR_COMPOSER:迪克牛仔
搜索邓丽君的歌曲	MUSIC_SEARCH	ARTIST_OR_COMPOSER:邓丽君
搜索邓丽欣的歌曲	MUSIC_SEARCH	ARTIST_OR_COMPOSER:邓丽欣
搜索邓福如的歌曲	MUSIC_SEARCH	ARTIST_OR_COMPOSER:邓福如
搜索邓紫棋的歌曲	MUSIC_SEARCH	ARTIST_OR_COMPOSER:邓紫棋
搜索那英的歌曲	MUSIC_SEARCH	ARTIST_OR_COMPOSER:那英
搜索邰正宵的歌曲	MUSIC_SEARCH	ARTIST_OR_COMPOSER:邰正宵
搜索邱永传的歌曲	MUSIC_SEARCH	ARTIST_OR_COMPOSER:邱永传
搜索郁可唯的歌曲	MUSIC_SEARCH	ARTIST_OR_COMPOSER:郁可唯
搜索郑中基的歌曲	MUSIC_SEARCH	ARTIST_OR_COMPOSER:郑中基
搜索郑伊健的歌曲	MUSIC_SEARCH	ARTIST_OR_COMPOSER:郑伊健
搜索郑小宇的歌曲	MUSIC_SEARCH	ARTIST_OR_COMPOSER:郑小宇
搜索郑智化的歌曲	MUSIC_SEARCH	ARTIST_OR_COMPOSER:郑智化
搜索郑源的歌曲	MUSIC_SEARCH	ARTIST_OR_COMPOSER:郑源
搜索郑秀文的歌曲	MUSIC_SEARCH	ARTIST_OR_COMPOSER:郑秀文
搜索郭富城的歌曲	MUSIC_SEARCH	ARTIST_OR_COMPOSER:郭富城
搜索郭峰的歌曲	MUSIC_SEARCH	ARTIST_OR_COMPOSER:郭峰
搜索郭采洁的歌曲	MUSIC_SEARCH	ARTIST_OR_COMPOSER:郭采洁
搜索郭静的歌曲	MUSIC_SEARCH	ARTIST_OR_COMPOSER:郭静
搜索重口味这首歌	MUSIC_SEARCH	TITLE:重口味
搜索金娃娃的歌曲	MUSIC_SEARCH	ARTIST_OR_COMPOSER:金娃娃
搜索金池的歌曲	MUSIC_SEARCH	ARTIST_OR_COMPOSER:金池
搜索金泫雅的歌曲	MUSIC_SEARCH	ARTIST_OR_COMPOSER:金泫雅
搜索金艺林的歌曲	MUSIC_SEARCH	ARTIST_OR_COMPOSER:金艺林
搜索金莎的歌曲	MUSIC_SEARCH	ARTIST_OR_COMPOSER:金莎
搜索钉宫理恵的歌曲	MUSIC_SEARCH	ARTIST_OR_COMPOSER:钉宫理恵
搜索钟伟强唱的歌	MUSIC_SEARCH	ARTIST_OR_COMPOSER:钟伟强
搜索钟洁的歌曲	MUSIC_SEARCH	ARTIST_OR_COMPOSER:钟洁
搜索门丽的歌曲	MUSIC_SEARCH	ARTIST_OR_COMPOSER:门丽
搜索闫旭的歌曲	MUSIC_SEARCH	ARTIST_OR_COMPOSER:闫旭
搜索阿宝的歌曲	MUSIC_SEARCH	ARTIST_OR_COMPOSER:阿宝
搜索阿悄的歌曲	MUSIC_SEARCH	ARTIST_OR_COMPOSER:阿悄
搜索阿木的歌曲	MUSIC_SEARCH	ARTIST_OR_COMPOSER:阿木
搜索阿杜的歌曲	MUSIC_SEARCH	ARTIST_OR_COMPOSER:阿杜
搜索阿桑的歌曲	MUSIC_SEARCH	ARTIST_OR_COMPOSER:阿桑
搜索阿里郎的歌曲	MUSIC_SEARCH	ARTIST_OR_COMPOSER:阿里郎
搜索陈冠希的歌曲	MUSIC_SEARCH	ARTIST_OR_COMPOSER:陈冠希
搜索陈势安的歌曲	MUSIC_SEARCH	ARTIST_OR_COMPOSER:陈势安
搜索陈奕迅的歌曲	MUSIC_SEARCH	ARTIST_OR_COMPOSER:陈奕迅
搜索陈妍希的歌曲	MUSIC_SEARCH	ARTIST_OR_COMPOSER:陈妍希
搜索陈小春的歌曲	MUSIC_SEARCH	ARTIST_OR_COMPOSER:陈小春
搜索陈慧琳的歌曲	MUSIC_SEARCH	ARTIST_OR_COMPOSER:陈慧琳
搜索陈明的歌曲	MUSIC_SEARCH	ARTIST_OR_COMPOSER:陈明
搜索陈晓东的歌曲	MUSIC_SEARCH	ARTIST_OR_COMPOSER:陈晓东
搜索陈柏宇的歌曲	MUSIC_SEARCH	ARTIST_OR_COMPOSER:陈柏宇
搜索陈楚生的歌曲	MUSIC_SEARCH	ARTIST_OR_COMPOSER:陈楚生
搜索陈淑桦的歌曲	MUSIC_SEARCH	ARTIST_OR_COMPOSER:陈淑桦
搜索陈玉建的歌曲	MUSIC_SEARCH	ARTIST_OR_COMPOSER:陈玉建
搜索陈珊妮的歌曲	MUSIC_SEARCH	ARTIST_OR_COMPOSER:陈珊妮
搜索陈百强的歌曲	MUSIC_SEARCH	ARTIST_OR_COMPOSER:陈百强
搜索陈绮贞的歌曲	MUSIC_SEARCH	ARTIST_OR_COMPOSER:陈绮贞
搜索陈雅森的歌曲	MUSIC_SEARCH	ARTIST_OR_COMPOSER:陈雅森
搜索陈韵若的歌曲	MUSIC_SEARCH	ARTIST_OR_COMPOSER:陈韵若
搜索陶喆的歌曲	MUSIC_SEARCH	ARTIST_OR_COMPOSER:陶喆
搜索陶晶莹的歌曲	MUSIC_SEARCH	ARTIST_OR_COMPOSER:陶晶莹
搜索雨宗林的歌曲	MUSIC_SEARCH	ARTIST_OR_COMPOSER:雨宗林
搜索雷婷的歌曲	MUSIC_SEARCH	ARTIST_OR_COMPOSER:雷婷
搜索雷诺儿的歌曲	MUSIC_SEARCH	ARTIST_OR_COMPOSER:雷诺儿
搜索韩庚的歌曲	MUSIC_SEARCH	ARTIST_OR_COMPOSER:韩庚
搜索韩红的歌曲	MUSIC_SEARCH	ARTIST_OR_COMPOSER:韩红
搜索韩雪的歌曲	MUSIC_SEARCH	ARTIST_OR_COMPOSER:韩雪
搜索颜小健的歌曲	MUSIC_SEARCH	ARTIST_OR_COMPOSER:颜小健
搜索飘飘飘飘这首歌	MUSIC_SEARCH	TITLE:飘飘飘飘
搜索飞儿乐团的歌曲	MUSIC_SEARCH	ARTIST_OR_COMPOSER:飞儿乐团
搜索飞轮海的歌曲	MUSIC_SEARCH	ARTIST_OR_COMPOSER:飞轮海
搜索饶威的歌曲	MUSIC_SEARCH	ARTIST_OR_COMPOSER:饶威
搜索香香的歌曲	MUSIC_SEARCH	ARTIST_OR_COMPOSER:香香
搜索马健涛的歌曲	MUSIC_SEARCH	ARTIST_OR_COMPOSER:马健涛
搜索马克西姆的歌曲	MUSIC_SEARCH	ARTIST_OR_COMPOSER:马克西姆
搜索高恺蔚的歌曲	MUSIC_SEARCH	ARTIST_OR_COMPOSER:高恺蔚
搜索高胜美的歌曲	MUSIC_SEARCH	ARTIST_OR_COMPOSER:高胜美
搜索高进的歌曲	MUSIC_SEARCH	ARTIST_OR_COMPOSER:高进
搜索魏一宁的歌曲	MUSIC_SEARCH	ARTIST_OR_COMPOSER:魏一宁
搜索魔杰座	MUSIC_SEARCH	ALBUMNAME:魔杰座
搜索魔杰座这个专辑	MUSIC_SEARCH	ALBUMNAME:魔杰座
搜索麦当娜的歌曲	MUSIC_SEARCH	ARTIST_OR_COMPOSER:麦当娜
搜索黄义达的歌曲	MUSIC_SEARCH	ARTIST_OR_COMPOSER:黄义达
搜索黄品冠的歌曲	MUSIC_SEARCH	ARTIST_OR_COMPOSER:黄品冠
搜索黄品源的歌曲	MUSIC_SEARCH	ARTIST_OR_COMPOSER:黄品源
搜索黄家驹的歌曲	MUSIC_SEARCH	ARTIST_OR_COMPOSER:黄家驹
搜索黄小琥的歌曲	MUSIC_SEARCH	ARTIST_OR_COMPOSER:黄小琥
搜索黄晓明的歌曲	MUSIC_SEARCH	ARTIST_OR_COMPOSER:黄晓明
搜索黄绮珊的歌曲	MUSIC_SEARCH	ARTIST_OR_COMPOSER:黄绮珊
搜索黄贯中的歌曲	MUSIC_SEARCH	ARTIST_OR_COMPOSER:黄贯中
搜索黄鸿升的歌曲	MUSIC_SEARCH	ARTIST_OR_COMPOSER:黄鸿升
搜索黄龄的歌曲	MUSIC_SEARCH	ARTIST_OR_COMPOSER:黄龄
搜索黎明的歌曲	MUSIC_SEARCH	ARTIST_OR_COMPOSER:黎明
搜索黑豹的歌曲	MUSIC_SEARCH	ARTIST_OR_COMPOSER:黑豹
搜索黑鸭子的歌曲	MUSIC_SEARCH	ARTIST_OR_COMPOSER:黑鸭子
搜索黑龙的歌曲	MUSIC_SEARCH	ARTIST_OR_COMPOSER:黑龙
搜索齐秦的歌曲	MUSIC_SEARCH	ARTIST_OR_COMPOSER:齐秦
搜索龙井说唱的歌曲	MUSIC_SEARCH	ARTIST_OR_COMPOSER:龙井说唱
搜索龙梅子的歌曲	MUSIC_SEARCH	ARTIST_OR_COMPOSER:龙梅子
搜索龚玥的歌曲	MUSIC_SEARCH	ARTIST_OR_COMPOSER:龚玥
摇啊摇是哪个年代创作的	MUSIC_SEARCH	TITLE:摇啊摇
摇滚主耶稣的七里香	MUSIC_SEARCH	ARTIST_OR_COMPOSER:摇滚主耶稣	ALBUMNAME:七里香
摇滚吧情歌这个音乐专辑很流行么	MUSIC_SEARCH	ALBUMNAME:摇滚吧情歌
摇滚吧情歌里面都是什么年份的歌曲	MUSIC_SEARCH	ALBUMNAME:摇滚吧情歌
撒小乐团的美好	MUSIC_SEARCH	ARTIST_OR_COMPOSER:撒小乐团	ALBUMNAME:美好
改变常改变是哪位著名歌手唱的么	MUSIC_SEARCH	TITLE:改变常改变
放下的歌曲分类是什么	MUSIC_SEARCH	TITLE:放下
放开你的心很好听么	MUSIC_SEARCH	TITLE:放开你的心
放心不下是谁的专辑	MUSIC_SEARCH	ALBUMNAME:放心不下
放心不下是阿尔法音乐制作的么	MUSIC_SEARCH	ALBUMNAME:放心不下
放心不下这个专辑里是不是有十首歌	MUSIC_SEARCH	ALBUMNAME:放心不下
放心不下这张专辑下面有什么曲目	MUSIC_SEARCH	ALBUMNAME:放心不下
放心不下这张专辑是什么时候出的	MUSIC_SEARCH	ALBUMNAME:放心不下
文科生的一个下午这首歌比较好听么	MUSIC_SEARCH	TITLE:文科生的一个下午
斗牛是作做的曲	MUSIC_SEARCH	TITLE:斗牛
斜当是不是八十年代的经典老歌	MUSIC_SEARCH	year:八十年代	GENRE:经典老歌	TITLE:斜当
断点是谁作的词	MUSIC_SEARCH	TITLE:断点
新春游乐场在哪个专辑里	MUSIC_SEARCH	TITLE:新春游乐场
新生活是什么风格的歌曲	MUSIC_SEARCH	TITLE:新生活
旅愁的原唱是谁	MUSIC_SEARCH	TITLE:旅愁
无与伦比的美丽适不适合老年人听	MUSIC_SEARCH	TITLE:无与伦比的美丽
无乐不作是不是比较好听	MUSIC_SEARCH	TITLE:无乐不作
无人值守这首歌的音乐好听么	MUSIC_SEARCH	TITLE:无人值守
无处不在里面有什么英文歌曲	MUSIC_SEARCH	GENRE:英文歌曲	ALBUMNAME:无处不在
无尽空虚这首歌好听么	MUSIC_SEARCH	TITLE:无尽空虚
无情的坦白是哪个专辑里的歌	MUSIC_SEARCH	TITLE:无情的坦白
无罪释放这首歌很有名么	MUSIC_SEARCH	TITLE:无罪释放
无色花是哪个电视剧的片尾曲	MUSIC_SEARCH	TITLE:无色花
既然爱了多长	MUSIC_SEARCH	TITLE:既然爱了
日出是最近才出的歌么	MUSIC_SEARCH	TITLE:日出
日语歌曲有几个	MUSIC_SEARCH	GENRE:日语歌曲
旧情人在哪个专辑里	MUSIC_SEARCH	TITLE:旧情人
早操晚操是哪个专辑里的歌	MUSIC_SEARCH	TITLE:早操晚操
早知道爱上你这首歌有没有吸收拉丁美洲的元素	MUSIC_SEARCH	TITLE:早知道爱上你
旺得福发行当天的销量如何	MUSIC_SEARCH	ALBUMNAME:旺得福
旺得福是个什么类型的专辑	MUSIC_SEARCH	ALBUMNAME:旺得福
旺得福这张专辑几月几号发行的	MUSIC_SEARCH	ALBUMNAME:旺得福
旺得福这张专辑里有哪几首歌	MUSIC_SEARCH	ALBUMNAME:旺得福
旺得福里面有哪几首歌	MUSIC_SEARCH	ALBUMNAME:旺得福
明凯的最傻的男人	MUSIC_SEARCH	ARTIST_OR_COMPOSER:明凯	TITLE:最傻的男人
映山红属于什么人群会喜欢的歌曲	MUSIC_SEARCH	TITLE:映山红
显示二月填字游戏的歌词	MUSIC_SEARCH	TITLE:二月填字游戏
显示从一开始的英文歌词	MUSIC_SEARCH	TITLE:从一开始
显示你不是一个人的英文歌词	MUSIC_SEARCH	TITLE:你不是一个人
显示六字大明咒的中文歌词	MUSIC_SEARCH	TITLE:六字大明咒
显示千年痴心的歌词	MUSIC_SEARCH	TITLE:千年痴心
显示快点来爱我的英文歌词	MUSIC_SEARCH	TITLE:快点来爱我
显示想念的歌唱家	MUSIC_SEARCH	TITLE:想念
显示我的梦中情人的歌唱家	MUSIC_SEARCH	TITLE:我的梦中情人
显示战友还记得吗的歌词	MUSIC_SEARCH	TITLE:战友还记得吗
显示抒情的音乐	MUSIC_SEARCH	GENRE:抒情的音乐
显示既然爱了就不怕的中文歌词	MUSIC_SEARCH	TITLE:既然爱了就不怕
显示最流行的歌曲	MUSIC_SEARCH
显示最火的欧美女歌手	MUSIC_SEARCH	GENRE:欧美
显示歌曲列表	MUSIC_SEARCH
显示歌曲怀念的秋风的信息	MUSIC_SEARCH	TITLE:怀念的秋风
显示歌曲我试着假装的信息	MUSIC_SEARCH	TITLE:我试着假装
显示歌曲爱的冒险的信息	MUSIC_SEARCH	TITLE:爱的冒险
显示歌曲蛋佬的棉袄的信息	MUSIC_SEARCH	TITLE:蛋佬的棉袄
显示殉情记的中文歌词	MUSIC_SEARCH	TITLE:殉情记
显示目前最火的歌手	MUSIC_SEARCH
显示直到最后的歌词	MUSIC_SEARCH	TITLE:直到最后
显示绵羊的英文歌词	MUSIC_SEARCH	TITLE:绵羊
显示薇多莉亚的秘密的歌唱家	MUSIC_SEARCH	TITLE:薇多莉亚的秘密
显示说唱乐	MUSIC_SEARCH	GENRE:说唱乐
显示还隐隐作痛的歌唱家	MUSIC_SEARCH	TITLE:还隐隐作痛
显示这个歌曲的歌词	MUSIC_PLAY	ANAPHOR:这个歌曲
显示逃避你的中文歌词	MUSIC_SEARCH	TITLE:逃避你
晴天娃娃是个什么类的歌曲	MUSIC_SEARCH	TITLE:晴天娃娃
暂住证唱的我会更好	MUSIC_SEARCH	ARTIST_OR_COMPOSER:暂住证	TITLE:我会更好
暂存里有几首歌	MUSIC_SEARCH	ALBUMNAME:暂存
暂存里的歌都算不算流行音乐啊	MUSIC_SEARCH	GENRE:流行音乐	ALBUMNAME:暂存
暗示是个什么类的歌曲	MUSIC_SEARCH	TITLE:暗示
暗里的感觉这首歌是什么时候出的	MUSIC_SEARCH	TITLE:暗里的感觉
暴风中这首歌很有名么	MUSIC_SEARCH	TITLE:暴风中
曲婉婷的歌	MUSIC_SEARCH	ARTIST_OR_COMPOSER:曲婉婷
曲婉婷的歌曲	MUSIC_SEARCH	ARTIST_OR_COMPOSER:曲婉婷
曾佩媛唱了春秋吗	MUSIC_SEARCH	ARTIST_OR_COMPOSER:曾佩媛	TITLE:春秋
替我搜索七里香这个专辑	MUSIC_SEARCH	ALBUMNAME:七里香
替我搜索专辑不可不信缘	MUSIC_SEARCH	ALBUMNAME:不可不信缘
替我搜索专辑乐行者	MUSIC_SEARCH	ALBUMNAME:乐行者
替我搜索专辑再会了	MUSIC_SEARCH	ALBUMNAME:再会了
替我搜索专辑双霸	MUSIC_SEARCH	ALBUMNAME:双霸
替我搜索专辑只知道此刻爱你	MUSIC_SEARCH	ALBUMNAME:只知道此刻爱你
替我搜索专辑回到你身边	MUSIC_SEARCH	ALBUMNAME:回到你身边
替我搜索专辑如果你是我的传说	MUSIC_SEARCH	ALBUMNAME:如果你是我的传说
替我搜索专辑情感的禁区	MUSIC_SEARCH	ALBUMNAME:情感的禁区
替我搜索专辑曹操	MUSIC_SEARCH	ALBUMNAME:曹操
替我搜索专辑第二天堂	MUSIC_SEARCH	ALBUMNAME:第二天堂
替我搜索专辑西界	MUSIC_SEARCH	ALBUMNAME:西界
替我搜索专辑音乐进化全过程	MUSIC_SEARCH	ALBUMNAME:音乐进化全过程
替我搜索依然范特西这个专辑	MUSIC_SEARCH	ALBUMNAME:依然范特西
替我搜索八度空间这个专辑	MUSIC_SEARCH	ALBUMNAME:八度空间
替我搜索十一月的萧邦这个专辑	MUSIC_SEARCH	ALBUMNAME:十一月的萧邦
替我搜索叫Q版一族的专辑	MUSIC_SEARCH	ALBUMNAME:Q版一族
替我搜索叫五时三十分的专辑	MUSIC_SEARCH	ALBUMNAME:五时三十分
替我搜索叫因为爱的专辑	MUSIC_SEARCH	ALBUMNAME:因为爱
替我搜索叫天意的专辑	MUSIC_SEARCH	ALBUMNAME:天意
替我搜索叫忘情水的专辑	MUSIC_SEARCH	ALBUMNAME:忘情水
替我搜索叫情未了的专辑	MUSIC_SEARCH	ALBUMNAME:情未了
替我搜索叫来生缘的专辑	MUSIC_SEARCH	ALBUMNAME:来生缘
替我搜索叫爱在刻骨铭心时的专辑	MUSIC_SEARCH	ALBUMNAME:爱在刻骨铭心时
替我搜索叫爱的空间的专辑	MUSIC_SEARCH	ALBUMNAME:爱的空间
替我搜索叫真我的风采的专辑	MUSIC_SEARCH	ALBUMNAME:真我的风采
替我搜索叫真生命的专辑	MUSIC_SEARCH	ALBUMNAME:真生命
替我搜索叫谢谢你的爱的专辑	MUSIC_SEARCH	ALBUMNAME:谢谢你的爱
替我搜索叶惠美这个专辑	MUSIC_SEARCH	ALBUMNAME:叶惠美
替我搜索名为你可知道我爱谁的专辑	MUSIC_SEARCH	ALBUMNAME:你可知道我爱谁
替我搜索名为偿还的专辑	MUSIC_SEARCH	ALBUMNAME:偿还
替我搜索名为初次尝到寂寞的专辑	MUSIC_SEARCH	ALBUMNAME:初次尝到寂寞
替我搜索名为千言万语的专辑	MUSIC_SEARCH	ALBUMNAME:千言万语
替我搜索名为南海姑娘的专辑	MUSIC_SEARCH	ALBUMNAME:南海姑娘
替我搜索名为天国的情人的专辑	MUSIC_SEARCH	ALBUMNAME:天国的情人
替我搜索名为小城故事的专辑	MUSIC_SEARCH	ALBUMNAME:小城故事
替我搜索名为往事如昨的专辑	MUSIC_SEARCH	ALBUMNAME:往事如昨
替我搜索名为快乐的恰恰姑娘的专辑	MUSIC_SEARCH	ALBUMNAME:快乐的恰恰姑娘
替我搜索名为水上人的专辑	MUSIC_SEARCH	ALBUMNAME:水上人
替我搜索名为淡淡幽情的专辑	MUSIC_SEARCH	ALBUMNAME:淡淡幽情
替我搜索名为漫步人生路的专辑	MUSIC_SEARCH	ALBUMNAME:漫步人生路
替我搜索名为甜蜜蜜的专辑	MUSIC_SEARCH	ALBUMNAME:甜蜜蜜
替我搜索名叫一只牛的异想世界的专辑	MUSIC_SEARCH	ALBUMNAME:一只牛的异想世界
替我搜索名叫不了情的专辑	MUSIC_SEARCH	ALBUMNAME:不了情
替我搜索名叫人间爱的专辑	MUSIC_SEARCH	ALBUMNAME:人间爱
替我搜索名叫再说一次我爱你的专辑	MUSIC_SEARCH	ALBUMNAME:再说一次我爱你
替我搜索名叫别把眉儿皱的专辑	MUSIC_SEARCH	ALBUMNAME:别把眉儿皱
替我搜索名叫声音的专辑	MUSIC_SEARCH	ALBUMNAME:声音
替我搜索名叫天开了的专辑	MUSIC_SEARCH	ALBUMNAME:天开了
替我搜索名叫如果有一天的专辑	MUSIC_SEARCH	ALBUMNAME:如果有一天
替我搜索名叫妹力新世纪的专辑	MUSIC_SEARCH	ALBUMNAME:妹力新世纪
替我搜索名叫心蓝的专辑	MUSIC_SEARCH	ALBUMNAME:心蓝
替我搜索名叫爱像一首歌的专辑	MUSIC_SEARCH	ALBUMNAME:爱像一首歌
替我搜索名叫爱无知的专辑	MUSIC_SEARCH	ALBUMNAME:爱无知
替我搜索名叫美丽的一天的专辑	MUSIC_SEARCH	ALBUMNAME:美丽的一天
替我搜索名字叫丝路的专辑	MUSIC_SEARCH	ALBUMNAME:丝路
替我搜索名字叫亲亲的专辑	MUSIC_SEARCH	ALBUMNAME:亲亲
替我搜索名字叫今天情人节的专辑	MUSIC_SEARCH	ALBUMNAME:今天情人节
替我搜索名字叫完美的一天的专辑	MUSIC_SEARCH	ALBUMNAME:完美的一天
替我搜索名字叫崇拜的专辑	MUSIC_SEARCH	ALBUMNAME:崇拜
替我搜索名字叫恋爱的力量的专辑	MUSIC_SEARCH	ALBUMNAME:恋爱的力量
替我搜索名字叫我爱邓丽君的专辑	MUSIC_SEARCH	ALBUMNAME:我爱邓丽君
替我搜索名字叫我要的幸福的专辑	MUSIC_SEARCH	ALBUMNAME:我要的幸福
替我搜索名字叫未完成的专辑	MUSIC_SEARCH	ALBUMNAME:未完成
替我搜索名字叫自选辑的专辑	MUSIC_SEARCH	ALBUMNAME:自选辑
替我搜索名字叫逆光的专辑	MUSIC_SEARCH	ALBUMNAME:逆光
替我搜索名字叫风筝的专辑	MUSIC_SEARCH	ALBUMNAME:风筝
替我搜索名字是一个小心愿的专辑	MUSIC_SEARCH	ALBUMNAME:一个小心愿
替我搜索名字是一封情书的专辑	MUSIC_SEARCH	ALBUMNAME:一封情书
替我搜索名字是再见我的爱人的专辑	MUSIC_SEARCH	ALBUMNAME:再见我的爱人
替我搜索名字是原乡人的专辑	MUSIC_SEARCH	ALBUMNAME:原乡人
替我搜索名字是又见炊烟的专辑	MUSIC_SEARCH	ALBUMNAME:又见炊烟
替我搜索名字是在水一方的专辑	MUSIC_SEARCH	ALBUMNAME:在水一方
替我搜索名字是姐妹的专辑	MUSIC_SEARCH	ALBUMNAME:姐妹
替我搜索名字是小村之恋的专辑	MUSIC_SEARCH	ALBUMNAME:小村之恋
替我搜索名字是永恒巨星典藏版的专辑	MUSIC_SEARCH	ALBUMNAME:永恒巨星典藏版
替我搜索名字是牵手的专辑	MUSIC_SEARCH	ALBUMNAME:牵手
替我搜索名字是的专辑歌声妹影	MUSIC_SEARCH	ALBUMNAME:歌声妹影
替我搜索名字是艳红小曲的专辑	MUSIC_SEARCH	ALBUMNAME:艳红小曲
替我搜索唯舞独尊这个专辑	MUSIC_SEARCH	ALBUMNAME:唯舞独尊
替我搜索城堡这个专辑	MUSIC_SEARCH	ALBUMNAME:城堡
替我搜索爱的练习语这个专辑	MUSIC_SEARCH	ALBUMNAME:爱的练习语
替我搜索看我72变这个专辑	MUSIC_SEARCH	ALBUMNAME:看我72变
替我搜索舞娘这个专辑	MUSIC_SEARCH	ALBUMNAME:舞娘
替我搜索花蝴蝶这个专辑	MUSIC_SEARCH	ALBUMNAME:花蝴蝶
替我搜索范特西这个专辑	MUSIC_SEARCH	ALBUMNAME:范特西
替我搜索跨时代这个专辑	MUSIC_SEARCH	ALBUMNAME:跨时代
替我搜索魔杰座这个专辑	MUSIC_SEARCH	ALBUMNAME:魔杰座
替我查找专辑一起长大	MUSIC_SEARCH	ALBUMNAME:一起长大
替我查找专辑三天三夜	MUSIC_SEARCH	ALBUMNAME:三天三夜
替我查找专辑亲爱的理由	MUSIC_SEARCH	ALBUMNAME:亲爱的理由
替我查找专辑傻瓜探戈	MUSIC_SEARCH	ALBUMNAME:傻瓜探戈
替我查找专辑再见你好吗	MUSIC_SEARCH	ALBUMNAME:再见你好吗
替我查找专辑天蓝如海	MUSIC_SEARCH	ALBUMNAME:天蓝如海
替我查找专辑我们	MUSIC_SEARCH	ALBUMNAME:我们
替我查找专辑我知道你离我不远	MUSIC_SEARCH	ALBUMNAME:我知道你离我不远
替我查找专辑桐花	MUSIC_SEARCH	ALBUMNAME:桐花
替我查找专辑盛开	MUSIC_SEARCH	ALBUMNAME:盛开
替我查找专辑看海	MUSIC_SEARCH	ALBUMNAME:看海
替我查找专辑谢幕	MUSIC_SEARCH	ALBUMNAME:谢幕
替我查找专辑青春	MUSIC_SEARCH	ALBUMNAME:青春
替我查找专辑青春再见	MUSIC_SEARCH	ALBUMNAME:青春再见
替我查找乐之路这个专辑	MUSIC_SEARCH	ALBUMNAME:乐之路
替我查找何必再拖这个专辑	MUSIC_SEARCH	ALBUMNAME:何必再拖
替我查找叫一夜长大的专辑	MUSIC_SEARCH	ALBUMNAME:一夜长大
替我查找叫一肩之隔的专辑	MUSIC_SEARCH	ALBUMNAME:一肩之隔
替我查找叫一首心歌的专辑	MUSIC_SEARCH	ALBUMNAME:一首心歌
替我查找叫伤心的女人怎么了的专辑	MUSIC_SEARCH	ALBUMNAME:伤心的女人怎么了
替我查找叫勇气的专辑	MUSIC_SEARCH	ALBUMNAME:勇气
替我查找叫捍卫阳光的专辑	MUSIC_SEARCH	ALBUMNAME:捍卫阳光
替我查找叫漂的专辑	MUSIC_SEARCH	ALBUMNAME:漂
替我查找叫爱爱爱爱的专辑	MUSIC_SEARCH	ALBUMNAME:爱爱爱爱
替我查找叫爱过那张脸的专辑	MUSIC_SEARCH	ALBUMNAME:爱过那张脸
替我查找叫的专辑时间煮雨	MUSIC_SEARCH	ALBUMNAME:时间煮雨
替我查找叫美丽人生的专辑	MUSIC_SEARCH	ALBUMNAME:美丽人生
替我查找叫走进你的梦的专辑	MUSIC_SEARCH	ALBUMNAME:走进你的梦
替我查找叫闪亮的星的专辑	MUSIC_SEARCH	ALBUMNAME:闪亮的星
替我查找名叫三的专辑	MUSIC_SEARCH	ALBUMNAME:三
替我查找名叫世界看我的专辑	MUSIC_SEARCH	ALBUMNAME:世界看我
替我查找名叫会飞的贼的专辑	MUSIC_SEARCH	ALBUMNAME:会飞的贼
替我查找名叫光阴的故事 的专辑	MUSIC_SEARCH	ALBUMNAME:光阴的故事
替我查找名叫情话的专辑	MUSIC_SEARCH	ALBUMNAME:情话
替我查找名叫放心不下的专辑	MUSIC_SEARCH	ALBUMNAME:放心不下
替我查找名叫枪神的荣耀的专辑	MUSIC_SEARCH	ALBUMNAME:枪神的荣耀
替我查找名叫漫游的专辑	MUSIC_SEARCH	ALBUMNAME:漫游
替我查找名叫美好的专辑	MUSIC_SEARCH	ALBUMNAME:美好
替我查找名叫能不能的专辑	MUSIC_SEARCH	ALBUMNAME:能不能
替我查找名叫致青春的专辑	MUSIC_SEARCH	ALBUMNAME:致青春
替我查找名叫陪我去流浪的专辑	MUSIC_SEARCH	ALBUMNAME:陪我去流浪
替我查找名叫黄河长江的专辑	MUSIC_SEARCH	ALBUMNAME:黄河长江
替我查找名字叫下一个天亮的专辑	MUSIC_SEARCH	ALBUMNAME:下一个天亮
替我查找名字叫不想懂得的专辑	MUSIC_SEARCH	ALBUMNAME:不想懂得
替我查找名字叫华丽的冒险的专辑	MUSIC_SEARCH	ALBUMNAME:华丽的冒险
替我查找名字叫在树上唱歌的专辑	MUSIC_SEARCH	ALBUMNAME:在树上唱歌
替我查找名字叫太阳的专辑	MUSIC_SEARCH	ALBUMNAME:太阳
替我查找名字叫小宇宙的专辑	MUSIC_SEARCH	ALBUMNAME:小宇宙
替我查找名字叫我不想忘记你的专辑	MUSIC_SEARCH	ALBUMNAME:我不想忘记你
替我查找名字叫我的未来不是梦的专辑	MUSIC_SEARCH	ALBUMNAME:我的未来不是梦
替我查找名字叫无与伦比的美丽的专辑	MUSIC_SEARCH	ALBUMNAME:无与伦比的美丽
替我查找名字叫独一无二的专辑	MUSIC_SEARCH	ALBUMNAME:独一无二
替我查找名字叫苏打绿的专辑	MUSIC_SEARCH	ALBUMNAME:苏打绿
替我查找名字叫让我想一想的专辑	MUSIC_SEARCH	ALBUMNAME:让我想一想
替我查找名字叫还是会寂寞的专辑	MUSIC_SEARCH	ALBUMNAME:还是会寂寞
替我查找名字叫迟到千年的专辑	MUSIC_SEARCH	ALBUMNAME:迟到千年
替我查找天天有喜这个专辑	MUSIC_SEARCH	ALBUMNAME:天天有喜
替我查找太平盛世这个专辑	MUSIC_SEARCH	ALBUMNAME:太平盛世
替我查找太美丽这个专辑	MUSIC_SEARCH	ALBUMNAME:太美丽
替我查找好想你这个专辑	MUSIC_SEARCH	ALBUMNAME:好想你
替我查找我是海棠这个专辑	MUSIC_SEARCH	ALBUMNAME:我是海棠
替我查找我是海雅谷慕这个专辑	MUSIC_SEARCH	ALBUMNAME:我是海雅谷慕
替我查找拾伍这个专辑	MUSIC_SEARCH	ALBUMNAME:拾伍
替我查找爱的筹码这个专辑	MUSIC_SEARCH	ALBUMNAME:爱的筹码
替我查找这宅无处不在 个专辑	MUSIC_SEARCH	ALBUMNAME:宅无处不在
替我查找音乐新浪潮这个专辑	MUSIC_SEARCH	ALBUMNAME:音乐新浪潮
替我查找黑色橙子这个专辑	MUSIC_SEARCH	ALBUMNAME:黑色橙子
最后一首歌是什么	MUSIC_PLAY	ANAPHOR:最后一首歌
最后的拥抱属于什么音乐	MUSIC_SEARCH	TITLE:最后的拥抱
最后的温柔这个专辑是谁做的	MUSIC_SEARCH	ALBUMNAME:最后的温柔
最后的玫瑰的作曲灵感来源于什么	MUSIC_SEARCH	TITLE:最后的玫瑰
最好给最好是哪位著名歌手唱的么	MUSIC_SEARCH	TITLE:最好给最好
最心疼的人只有你属于什么人群会喜欢的歌曲	MUSIC_SEARCH	TITLE:最心疼的人只有你
最最这首歌在什么专辑	MUSIC_SEARCH	TITLE:最最
最美好的话是不是在六十年代很流行	MUSIC_SEARCH	TITLE:最美好的话	year:六十年代
月亮惹的祸这首歌所在的专辑是什么时候发行的	MUSIC_SEARCH	TITLE:月亮惹的祸
月亮黑面这个歌曲好不好听	MUSIC_SEARCH	TITLE:月亮黑面
月光边境的曲子是抄的什么歌	MUSIC_SEARCH	TITLE:月光边境
月娘光光是谁作的曲	MUSIC_SEARCH	TITLE:月娘光光
月球漫步这张专辑是什么时候出的	MUSIC_SEARCH	ALBUMNAME:月球漫步
有个性是谁唱的	MUSIC_SEARCH	TITLE:有个性
有心人是什么样的歌曲	MUSIC_SEARCH	TITLE:有心人
有所谓的专辑是什么时候发行的	MUSIC_SEARCH	TITLE:有所谓
有梦好甜蜜是一首情歌么	MUSIC_SEARCH	GENRE:情歌	TITLE:有梦好甜蜜
有没有electro类型的音乐	MUSIC_SEARCH	GENRE:electro
有没有house类型的音乐	MUSIC_SEARCH	GENRE:house
有没有reggae类型的音乐	MUSIC_SEARCH	GENRE:reggae
有没有七十年代的老歌	MUSIC_SEARCH	year:七十年代	GENRE:老歌
有没有中国传统音乐	MUSIC_SEARCH	GENRE:中国传统音乐
有没有八十年代的情歌	MUSIC_SEARCH	year:八十年代
有没有吉他曲	MUSIC_SEARCH	GENRE:吉他曲
有没有嘻哈音乐	MUSIC_SEARCH	GENRE:嘻哈音乐
有没有好听的背景音乐	MUSIC_SEARCH	GENRE:背景音乐
有没有巴西音乐类型的音乐	MUSIC_SEARCH	GENRE:巴西音乐
有没有摇滚乐	MUSIC_SEARCH	GENRE:摇滚乐
有没有摇滚类型的音乐	MUSIC_SEARCH	GENRE:摇滚
有没有朋克类型的音乐	MUSIC_SEARCH	GENRE:朋克
有没有死亡金属类型的音乐	MUSIC_SEARCH	GENRE:死亡金属
有没有毁灭金属类型的音乐	MUSIC_SEARCH	GENRE:毁灭金属
有没有民歌类型的音乐	MUSIC_SEARCH	GENRE:民歌
有没有灵魂乐曲类型的音乐	MUSIC_SEARCH	GENRE:灵魂乐曲
有没有管弦乐类型的音乐	MUSIC_SEARCH	GENRE:管弦乐
有没有经典歌曲	MUSIC_SEARCH	GENRE:经典歌曲
有没有艺术摇滚类型的音乐	MUSIC_SEARCH	GENRE:艺术摇滚
有没有节奏布鲁斯类型的音乐	MUSIC_SEARCH	GENRE:节奏布鲁斯
有没有藏族音乐	MUSIC_SEARCH	GENRE:藏族音乐
有没有迪斯科类型的音乐	MUSIC_SEARCH	GENRE:迪斯科
有没有那么一首歌会让你想有几个小节	MUSIC_SEARCH	TITLE:有没有那么一首歌会让你想
有没有金属乐类型的音乐	MUSIC_SEARCH	GENRE:金属乐
有谁演唱过唯虫这首歌曲	MUSIC_SEARCH	TITLE:唯虫
有谁演唱过失忆备忘录这首歌曲	MUSIC_SEARCH	TITLE:失忆备忘录
有谁演唱过恋东方这首歌曲	MUSIC_SEARCH	TITLE:恋东方
有谁演唱过耶路撒冷的星空这首歌曲	MUSIC_SEARCH	TITLE:耶路撒冷的星空
朋友首日封这首歌是哪个歌手的	MUSIC_SEARCH	TITLE:朋友首日封
望天的原版是什么歌	MUSIC_SEARCH	TITLE:望天
未知数现在是不是很流行	MUSIC_SEARCH	TITLE:未知数
本命年的作曲是谁	MUSIC_SEARCH	TITLE:本命年
朴海珍专辑的信息	MUSIC_SEARCH	ARTIST_OR_COMPOSER:朴海珍
李代沫的歌都好听么	MUSIC_SEARCH	ARTIST_OR_COMPOSER:李代沫
李元硕唱过晚来的爱情吗	MUSIC_SEARCH	ARTIST_OR_COMPOSER:李元硕	TITLE:晚来的爱情
李千娜的庐州月	MUSIC_SEARCH	ARTIST_OR_COMPOSER:李千娜	TITLE:庐州月
李恕权唱过的中国歌曲	MUSIC_SEARCH	ARTIST_OR_COMPOSER:李恕权	GENRE:中国歌曲
李智楠专辑的信息	MUSIC_SEARCH	ARTIST_OR_COMPOSER:李智楠
李琦尝过几首歌	MUSIC_SEARCH	ARTIST_OR_COMPOSER:李琦
李进唱过大暴走吗	MUSIC_SEARCH	ARTIST_OR_COMPOSER:李进	TITLE:大暴走
李霄云的专辑列表	MUSIC_SEARCH	ARTIST_OR_COMPOSER:李霄云
李风持的专辑列表	MUSIC_SEARCH	ARTIST_OR_COMPOSER:李风持
杨丹歌组	MUSIC_SEARCH	ARTIST_OR_COMPOSER:杨丹
杨哲唱过的情人节	MUSIC_SEARCH	ARTIST_OR_COMPOSER:杨哲	GENRE:情人节
杨坤专辑的信息	MUSIC_SEARCH	ARTIST_OR_COMPOSER:杨坤
杨宗纬的歌曲查一查	MUSIC_SEARCH	ARTIST_OR_COMPOSER:杨宗纬
杨小琳专辑的信息	MUSIC_SEARCH	ARTIST_OR_COMPOSER:杨小琳
杨立钛专辑的信息	MUSIC_SEARCH	ARTIST_OR_COMPOSER:杨立钛
杨蔓唱的真的想见你	MUSIC_SEARCH	ARTIST_OR_COMPOSER:杨蔓	TITLE:真的想见你
杰伦里面是不是都是七十年代的歌	MUSIC_SEARCH	year:七十年代	ALBUMNAME:杰伦
杰特歌组	MUSIC_SEARCH	ARTIST_OR_COMPOSER:杰特
林保怡专辑的信息	MUSIC_SEARCH	ARTIST_OR_COMPOSER:林保怡
林叶亭唱了为了谁吗	MUSIC_SEARCH	ARTIST_OR_COMPOSER:林叶亭	TITLE:为了谁
林宥嘉播放列表	MUSIC_SEARCH	ARTIST_OR_COMPOSER:林宥嘉
林建亨歌组	MUSIC_SEARCH	ARTIST_OR_COMPOSER:林建亨
林忆莲的歌都好不好听	MUSIC_SEARCH	ARTIST_OR_COMPOSER:林忆莲
林志炫专辑的信息	MUSIC_SEARCH	ARTIST_OR_COMPOSER:林志炫
林睿一新专辑	MUSIC_SEARCH	ARTIST_OR_COMPOSER:林睿一
果汁分你一半的作词家叫什么名字	MUSIC_SEARCH	TITLE:果汁分你一半
柔情歌曲播放列表	MUSIC_SEARCH	GENRE:柔情歌曲
柠檬草的味道的什么地区的歌	MUSIC_SEARCH	TITLE:柠檬草的味道
查一下不可不信缘这首歌	MUSIC_SEARCH	TITLE:不可不信缘
查一下冰雨这首歌	MUSIC_SEARCH	TITLE:冰雨
查一下回来吧好吗这首歌	MUSIC_SEARCH	TITLE:回来吧好吗
查一下歌曲亲爱的妈妈	MUSIC_SEARCH	TITLE:亲爱的妈妈
查一下歌曲同床	MUSIC_SEARCH	TITLE:同床
查一下歌曲妈妈的脸	MUSIC_SEARCH	TITLE:妈妈的脸
查一下歌曲影帝无用	MUSIC_SEARCH	TITLE:影帝无用
查一下歌曲拥抱你	MUSIC_SEARCH	TITLE:拥抱你
查一下歌曲拥抱到明天	MUSIC_SEARCH	TITLE:拥抱到明天
查一下歌曲无情天	MUSIC_SEARCH	TITLE:无情天
查一下歌曲无须担心	MUSIC_SEARCH	TITLE:无须担心
查一下歌曲母亲	MUSIC_SEARCH	TITLE:母亲
查一下歌曲永远寂寞	MUSIC_SEARCH	TITLE:永远寂寞
查一下歌曲潮水	MUSIC_SEARCH	TITLE:潮水
查一下歌曲等我	MUSIC_SEARCH	TITLE:等我
查一下歌曲绝望的笑容这首歌	MUSIC_SEARCH	TITLE:绝望的笑容
查一下歌曲还记得我吗	MUSIC_SEARCH	TITLE:还记得我吗
查一下歌曲迷醉的双脸	MUSIC_SEARCH	TITLE:迷醉的双脸
查一下汗这首歌	MUSIC_SEARCH	TITLE:汗
查一下狠心的一课这首歌	MUSIC_SEARCH	TITLE:狠心的一课
查一下瓜牛这首歌	MUSIC_SEARCH	TITLE:瓜牛
查一下甘心这首歌	MUSIC_SEARCH	TITLE:甘心
查一下的士司机这首歌	MUSIC_SEARCH	TITLE:的士司机
查一下真爱是苦味这首歌	MUSIC_SEARCH	TITLE:真爱是苦味
查一下老夫妻这首歌	MUSIC_SEARCH	TITLE:老夫妻
查一下舞照跳这首歌	MUSIC_SEARCH	TITLE:舞照跳
查一下苦命梁祝这首歌	MUSIC_SEARCH	TITLE:苦命梁祝
查一下萍水相逢这首歌	MUSIC_SEARCH	TITLE:萍水相逢
查一下藕断丝连这首歌	MUSIC_SEARCH	TITLE:藕断丝连
查一下魔鬼在恋爱这首歌	MUSIC_SEARCH	TITLE:魔鬼在恋爱
查一查专辑一夜惊喜	MUSIC_SEARCH	ALBUMNAME:一夜惊喜
查一查专辑两种角色	MUSIC_SEARCH	ALBUMNAME:两种角色
查一查专辑天窗	MUSIC_SEARCH	ALBUMNAME:天窗
查一查专辑快枪手	MUSIC_SEARCH	ALBUMNAME:快枪手
查一查专辑我们是谁	MUSIC_SEARCH	ALBUMNAME:我们是谁
查一查专辑拾伍	MUSIC_SEARCH	ALBUMNAME:拾伍
查一查专辑日日月月	MUSIC_SEARCH	ALBUMNAME:日日月月
查一查专辑月光妈妈	MUSIC_SEARCH	ALBUMNAME:月光妈妈
查一查专辑爱的筹码	MUSIC_SEARCH	ALBUMNAME:爱的筹码
查一查专辑诸葛亮 	MUSIC_SEARCH	ALBUMNAME:诸葛亮
查一查专辑越战越勇	MUSIC_SEARCH	ALBUMNAME:越战越勇
查一查专辑降落 	MUSIC_SEARCH	ALBUMNAME:降落
查一查专辑飞天	MUSIC_SEARCH	ALBUMNAME:飞天
查一查九十年代摇滚类型的音乐	MUSIC_SEARCH	GENRE:九十年代摇滚
查一查二胡类型的音乐	MUSIC_SEARCH	GENRE:二胡
查一查八十年代流行音乐类型的音乐	MUSIC_SEARCH	GENRE:八十年代流行音乐
查一查军歌类型的音乐	MUSIC_SEARCH	GENRE:军歌
查一查单车这首歌	MUSIC_SEARCH	TITLE:单车
查一查圆舞曲类型的音乐	MUSIC_SEARCH	GENRE:圆舞曲
查一查土星环这首歌	MUSIC_SEARCH	TITLE:土星环
查一查多一点这首歌	MUSIC_SEARCH	TITLE:多一点
查一查奋斗这首歌	MUSIC_SEARCH	TITLE:奋斗
查一查富士山下这首歌	MUSIC_SEARCH	TITLE:富士山下
查一查小号类型的音乐	MUSIC_SEARCH	GENRE:小号
查一查小夜曲类型的音乐	MUSIC_SEARCH	GENRE:小夜曲
查一查开不了心这首歌	MUSIC_SEARCH	TITLE:开不了心
查一查心的距离这首歌	MUSIC_SEARCH	TITLE:心的距离
查一查我的开始在这里这首歌	MUSIC_SEARCH	TITLE:我的开始在这里
查一查拥抱这分钟这首歌	MUSIC_SEARCH	TITLE:拥抱这分钟
查一查摇篮曲类型的音乐	MUSIC_SEARCH	GENRE:摇篮曲
查一查无人之境这首歌	MUSIC_SEARCH	TITLE:无人之境
查一查时光倒流二十年这首歌	MUSIC_SEARCH	TITLE:时光倒流二十年
查一查明年今日这首歌	MUSIC_SEARCH	TITLE:明年今日
查一查最冷一天这首歌	MUSIC_SEARCH	TITLE:最冷一天
查一查永远是朋友这首歌	MUSIC_SEARCH	TITLE:永远是朋友
查一查沙龙这首歌	MUSIC_SEARCH	TITLE:沙龙
查一查沼气这首歌	MUSIC_SEARCH	TITLE:沼气
查一查爱上你是我眼睛的错这首歌	MUSIC_SEARCH	TITLE:爱上你是我眼睛的错
查一查笛子独奏类型的音乐	MUSIC_SEARCH	GENRE:笛子独奏
查一查美丽有罪这首歌	MUSIC_SEARCH	TITLE:美丽有罪
查一查美满人生这首歌	MUSIC_SEARCH	TITLE:美满人生
查一查臭美这首歌	MUSIC_SEARCH	TITLE:臭美
查一查萨克斯管类型的音乐	MUSIC_SEARCH	GENRE:萨克斯管
查一查落花流水这首歌	MUSIC_SEARCH	TITLE:落花流水
查一查解药这首歌	MUSIC_SEARCH	TITLE:解药
查一查进行曲类型的音乐	MUSIC_SEARCH	GENRE:进行曲
查一查酝酿这首歌	MUSIC_SEARCH	TITLE:酝酿
查一查钢琴曲类型的音乐	MUSIC_SEARCH	GENRE:钢琴曲
查一查阿怪这首歌	MUSIC_SEARCH	TITLE:阿怪
查一查黑择明这首歌	MUSIC_SEARCH	TITLE:黑择明
查找11月的肖邦里面的所有歌曲	MUSIC_SEARCH	ALBUMNAME:11月的肖邦
查找12新作里面的情歌	MUSIC_SEARCH	GENRE:情歌	ALBUMNAME:12新作
查找acappella类型的音乐	MUSIC_SEARCH	GENRE:acappella
查找ambient类型的音乐	MUSIC_SEARCH	GENRE:ambient
查找bossa nova类型的音乐	MUSIC_SEARCH	GENRE:bossa nova
查找breakbeat类型的音乐	MUSIC_SEARCH	GENRE:breakbeat
查找brit-hop类型的音乐	MUSIC_SEARCH	GENRE:brit-hop
查找drum类型的音乐	MUSIC_SEARCH	GENRE:drum
查找dub类型的音乐	MUSIC_SEARCH	GENRE:dub
查找hip-hop类型的音乐	MUSIC_SEARCH	GENRE:hip-hop
查找jungle类型的音乐	MUSIC_SEARCH	GENRE:jungle
查找new age类型的音乐	MUSIC_SEARCH	GENRE:new age
查找techno类型的音乐	MUSIC_SEARCH	GENRE:techno
查找trance类型的音乐	MUSIC_SEARCH	GENRE:trance
查找trip-hop类型的音乐	MUSIC_SEARCH	GENRE:trip-hop
查找world music类型的音乐	MUSIC_SEARCH	GENRE:world music
查找一下古典音乐吧	MUSIC_SEARCH	GENRE:古典音乐
查找一下法语的歌曲	MUSIC_SEARCH	GENRE:法语的歌曲
查找一下萨克斯曲	MUSIC_SEARCH	GENRE:萨克斯曲
查找一下许巍的歌	MUSIC_SEARCH	ARTIST_OR_COMPOSER:许巍
查找一些俄罗斯的音乐	MUSIC_SEARCH	GENRE:俄罗斯的音乐
查找一些在韩国比较流行的歌曲	MUSIC_SEARCH	GENRE:韩国	GENRE:流行
查找一路向北这首歌	MUSIC_SEARCH	TITLE:一路向北
查找七十年代的歌曲	MUSIC_SEARCH	year:七十年代
查找七十年代的经典摇滚乐	MUSIC_SEARCH	year:七十年代	GENRE:经典摇滚乐
查找七里香的发行日期	MUSIC_SEARCH	ALBUMNAME:七里香
查找七里香的销量	MUSIC_SEARCH	ALBUMNAME:七里香
查找三天三夜这张专辑	MUSIC_SEARCH	ALBUMNAME:三天三夜
查找不会分离里的日文歌	MUSIC_SEARCH	GENRE:日文歌	ALBUMNAME:不会分离
查找专辑一起长大	MUSIC_SEARCH	ALBUMNAME:一起长大
查找专辑七里香里的所有歌曲	MUSIC_SEARCH	ALBUMNAME:七里香
查找专辑三天三夜	MUSIC_SEARCH	ALBUMNAME:三天三夜
查找专辑三天三夜里的所有歌曲	MUSIC_SEARCH	ALBUMNAME:三天三夜
查找专辑亲爱的理由	MUSIC_SEARCH	ALBUMNAME:亲爱的理由
查找专辑依然范特西里的所有歌曲	MUSIC_SEARCH	ALBUMNAME:依然范特西
查找专辑傻瓜探戈	MUSIC_SEARCH	ALBUMNAME:傻瓜探戈
查找专辑再见你好吗	MUSIC_SEARCH	ALBUMNAME:再见你好吗
查找专辑十一月的肖邦里的所有歌曲	MUSIC_SEARCH	ALBUMNAME:十一月的肖邦
查找专辑天蓝如海	MUSIC_SEARCH	ALBUMNAME:天蓝如海
查找专辑我们	MUSIC_SEARCH	ALBUMNAME:我们
查找专辑我知道你离我不远	MUSIC_SEARCH	ALBUMNAME:我知道你离我不远
查找专辑桐花	MUSIC_SEARCH	ALBUMNAME:桐花
查找专辑盛开	MUSIC_SEARCH	ALBUMNAME:盛开
查找专辑看海	MUSIC_SEARCH	ALBUMNAME:看海
查找专辑谢幕	MUSIC_SEARCH	ALBUMNAME:谢幕
查找专辑青春	MUSIC_SEARCH	ALBUMNAME:青春
查找专辑青春再见	MUSIC_SEARCH	ALBUMNAME:青春再见
查找两年前的乌云然这首歌	MUSIC_SEARCH	year:两年前	TITLE:乌云然
查找两年前的放轻松这首歌	MUSIC_SEARCH	year:两年前	TITLE:放轻松
查找两年前的没有脸的人这首歌	MUSIC_SEARCH	year:两年前	TITLE:没有脸的人
查找两年前的流浪的心这首歌	MUSIC_SEARCH	year:两年前	TITLE:流浪的心
查找义勇军进行曲	MUSIC_SEARCH	TITLE:义勇军进行曲
查找乐之路这个专辑	MUSIC_SEARCH	ALBUMNAME:乐之路
查找九九女儿红的歌词	MUSIC_SEARCH	TITLE:九九女儿红
查找九十年代的歌曲	MUSIC_SEARCH	year:九十年代
查找九十年代的经典动漫歌曲	MUSIC_SEARCH	year:九十年代	GENRE:经典动漫歌曲
查找乱舞春秋这首歌	MUSIC_SEARCH	TITLE:乱舞春秋
查找他爱过我的歌曲信息	MUSIC_SEARCH	TITLE:他爱过我
查找会飞的贼的发行日期	MUSIC_SEARCH	ALBUMNAME:会飞的贼
查找会飞的贼里面的情歌	MUSIC_SEARCH	GENRE:情歌	ALBUMNAME:会飞的贼
查找何必再拖这个专辑	MUSIC_SEARCH	ALBUMNAME:何必再拖
查找你不一样这首歌	MUSIC_SEARCH	TITLE:你不一样
查找你好吗这张专辑	MUSIC_SEARCH	ALBUMNAME:你好吗
查找你好吗里面的所有歌曲	MUSIC_SEARCH	ALBUMNAME:你好吗
查找依然范特西	MUSIC_SEARCH	ALBUMNAME:依然范特西
查找依然范特西专辑	MUSIC_SEARCH	ALBUMNAME:依然范特西
查找八十年代奥运会主题曲	MUSIC_SEARCH	year:八十年代	TITLE:奥运会主题曲
查找八十年代的歌曲	MUSIC_SEARCH	year:八十年代
查找八度空间	MUSIC_SEARCH	ALBUMNAME:八度空间
查找八度空间专辑	MUSIC_SEARCH	ALBUMNAME:八度空间
查找再爱一遍的专辑的信息吧	MUSIC_SEARCH	ALBUMNAME:再爱一遍
查找再看一眼的评论怎么样	MUSIC_SEARCH	TITLE:再看一眼
查找再见你好吗里面的情歌	MUSIC_SEARCH	GENRE:情歌	ALBUMNAME:再见你好吗
查找刘德华唱过的歌曲	MUSIC_SEARCH	ARTIST_OR_COMPOSER:刘德华
查找到死都要18岁里面有哪几首歌曲	MUSIC_SEARCH	ALBUMNAME:到死都要18岁
查找动感的音乐	MUSIC_SEARCH	GENRE:动感的音乐
查找十一月的肖邦里面的歌曲的名字	MUSIC_SEARCH	ALBUMNAME:十一月的肖邦
查找十一月的萧邦	MUSIC_SEARCH	ALBUMNAME:十一月的萧邦
查找十一月的萧邦专辑	MUSIC_SEARCH	ALBUMNAME:十一月的萧邦
查找十光年的专辑的信息吧	MUSIC_SEARCH	ALBUMNAME:十光年
查找十光年的销量	MUSIC_SEARCH	ALBUMNAME:十光年
查找千山万水这首歌	MUSIC_SEARCH	TITLE:千山万水
查找华人女歌手	MUSIC_SEARCH	GENRE:华人
查找华人男歌手	MUSIC_SEARCH	GENRE:华人
查找华人的歌手列表	MUSIC_SEARCH	GENRE:华人
查找反方向的钟这首歌	MUSIC_SEARCH	TITLE:反方向的钟
查找取消资格在哪个专辑	MUSIC_SEARCH	TITLE:取消资格
查找古筝曲	MUSIC_SEARCH	GENRE:古筝曲
查找叫一夜长大的专辑	MUSIC_SEARCH	ALBUMNAME:一夜长大
查找叫一肩之隔的专辑	MUSIC_SEARCH	ALBUMNAME:一肩之隔
查找叫一首心歌的专辑	MUSIC_SEARCH	ALBUMNAME:一首心歌
查找叫伤心的女人怎么了的专辑	MUSIC_SEARCH	ALBUMNAME:伤心的女人怎么了
查找叫勇气的专辑	MUSIC_SEARCH	ALBUMNAME:勇气
查找叫捍卫阳光的专辑	MUSIC_SEARCH	ALBUMNAME:捍卫阳光
查找叫漂的专辑	MUSIC_SEARCH	ALBUMNAME:漂
查找叫爱爱爱爱的专辑	MUSIC_SEARCH	ALBUMNAME:爱爱爱爱
查找叫爱过那张脸的专辑	MUSIC_SEARCH	ALBUMNAME:爱过那张脸
查找叫的专辑时间煮雨	MUSIC_SEARCH	ALBUMNAME:时间煮雨
查找叫美丽人生的专辑	MUSIC_SEARCH	ALBUMNAME:美丽人生
查找叫走进你的梦的专辑	MUSIC_SEARCH	ALBUMNAME:走进你的梦
查找叫闪亮的星的专辑	MUSIC_SEARCH	ALBUMNAME:闪亮的星
查找叶惠美	MUSIC_SEARCH	ALBUMNAME:叶惠美
查找叶惠美专辑	MUSIC_SEARCH	ALBUMNAME:叶惠美
查找名叫三的专辑	MUSIC_SEARCH	ALBUMNAME:三
查找名叫世界看我的专辑	MUSIC_SEARCH	ALBUMNAME:世界看我
查找名叫会飞的贼的专辑	MUSIC_SEARCH	ALBUMNAME:会飞的贼
查找名叫光阴的故事 的专辑	MUSIC_SEARCH	ALBUMNAME:光阴的故事
查找名叫情话的专辑	MUSIC_SEARCH	ALBUMNAME:情话
查找名叫放心不下的专辑	MUSIC_SEARCH	ALBUMNAME:放心不下
查找名叫枪神的荣耀的专辑	MUSIC_SEARCH	ALBUMNAME:枪神的荣耀
查找名叫漫游的专辑	MUSIC_SEARCH	ALBUMNAME:漫游
查找名叫美好的专辑	MUSIC_SEARCH	ALBUMNAME:美好
查找名叫能不能的专辑	MUSIC_SEARCH	ALBUMNAME:能不能
查找名叫致青春的专辑	MUSIC_SEARCH	ALBUMNAME:致青春
查找名叫陪我去流浪的专辑	MUSIC_SEARCH	ALBUMNAME:陪我去流浪
查找名叫黄河长江的专辑	MUSIC_SEARCH	ALBUMNAME:黄河长江
查找名字叫下一个天亮的专辑	MUSIC_SEARCH	ALBUMNAME:下一个天亮
查找名字叫不想懂得的专辑	MUSIC_SEARCH	ALBUMNAME:不想懂得
查找名字叫华丽的冒险的专辑	MUSIC_SEARCH	ALBUMNAME:华丽的冒险
查找名字叫在树上唱歌的专辑	MUSIC_SEARCH	ALBUMNAME:在树上唱歌
查找名字叫太阳的专辑	MUSIC_SEARCH	ALBUMNAME:太阳
查找名字叫小宇宙的专辑	MUSIC_SEARCH	ALBUMNAME:小宇宙
查找名字叫我不想忘记你的专辑	MUSIC_SEARCH	ALBUMNAME:我不想忘记你
查找名字叫我的未来不是梦的专辑	MUSIC_SEARCH	ALBUMNAME:我的未来不是梦
查找名字叫无与伦比的美丽的专辑	MUSIC_SEARCH	ALBUMNAME:无与伦比的美丽
查找名字叫独一无二的专辑	MUSIC_SEARCH	ALBUMNAME:独一无二
查找名字叫苏打绿的专辑	MUSIC_SEARCH	ALBUMNAME:苏打绿
查找名字叫让我想一想的专辑	MUSIC_SEARCH	ALBUMNAME:让我想一想
查找名字叫还是会寂寞的专辑	MUSIC_SEARCH	ALBUMNAME:还是会寂寞
查找名字叫迟到千年的专辑	MUSIC_SEARCH	ALBUMNAME:迟到千年
查找名字是为梦而生的专辑	MUSIC_SEARCH	ALBUMNAME:为梦而生
查找名字是你是我的偶像的专辑	MUSIC_SEARCH	ALBUMNAME:你是我的偶像
查找名字是北京巷弄的专辑	MUSIC_SEARCH	ALBUMNAME:北京巷弄
查找名字是北京榜样的专辑	MUSIC_SEARCH	ALBUMNAME:北京榜样
查找名字是合照的专辑	MUSIC_SEARCH	ALBUMNAME:合照
查找名字是宣言的专辑	MUSIC_SEARCH	ALBUMNAME:宣言
查找名字是希望爱的专辑	MUSIC_SEARCH	ALBUMNAME:希望爱
查找名字是旅程的专辑	MUSIC_SEARCH	ALBUMNAME:旅程
查找名字是梦想家的专辑	MUSIC_SEARCH	ALBUMNAME:梦想家
查找名字是男人好难的专辑	MUSIC_SEARCH	ALBUMNAME:男人好难
查找名字是落单旅行的专辑	MUSIC_SEARCH	ALBUMNAME:落单旅行
查找名字是表演时间的专辑	MUSIC_SEARCH	ALBUMNAME:表演时间
查找名字是谢 安琪的专辑	MUSIC_SEARCH	ALBUMNAME:谢 安琪
查找名字是趣味人生的专辑	MUSIC_SEARCH	ALBUMNAME:趣味人生
查找名字是闪耀的专辑	MUSIC_SEARCH	ALBUMNAME:闪耀
查找名字是闯关的专辑	MUSIC_SEARCH	ALBUMNAME:闯关
查找周大侠的评论怎么样	MUSIC_SEARCH	TITLE:周大侠
查找周大侠这首歌	MUSIC_SEARCH	TITLE:周大侠
查找周杰伦的歌	MUSIC_SEARCH	ARTIST_OR_COMPOSER:周杰伦
查找咚吧啦这首歌的歌手	MUSIC_SEARCH	TITLE:咚吧啦
查找唱歌给你听这首歌的歌手	MUSIC_SEARCH	TITLE:唱歌给你听
查找嘻哈音乐	MUSIC_SEARCH	GENRE:嘻哈音乐
查找因你而在的专辑的信息吧	MUSIC_SEARCH	ALBUMNAME:因你而在
查找因你而在里面有哪几首歌	MUSIC_SEARCH	ALBUMNAME:因你而在
查找因你而在里面的情歌	MUSIC_SEARCH	GENRE:情歌	ALBUMNAME:因你而在
查找困兽之斗这首歌	MUSIC_SEARCH	TITLE:困兽之斗
查找地下情这首歌的下载量	MUSIC_SEARCH	TITLE:地下情
查找夜蝶的歌词吧	MUSIC_SEARCH	TITLE:夜蝶
查找天地一斗这首歌	MUSIC_SEARCH	TITLE:天地一斗
查找天天有喜这个专辑	MUSIC_SEARCH	ALBUMNAME:天天有喜
查找太平盛世这个专辑	MUSIC_SEARCH	ALBUMNAME:太平盛世
查找太美丽这个专辑	MUSIC_SEARCH	ALBUMNAME:太美丽
查找好想你这个专辑	MUSIC_SEARCH	ALBUMNAME:好想你
查找好的情人这张专辑	MUSIC_SEARCH	ALBUMNAME:好的情人
查找娘子这首歌	MUSIC_SEARCH	TITLE:娘子
查找存在的力量里的日文歌	MUSIC_SEARCH	GENRE:日文歌	ALBUMNAME:存在的力量
查找存在的力量里面有哪几首歌曲	MUSIC_SEARCH	ALBUMNAME:存在的力量
查找孟楠尝过的歌	MUSIC_SEARCH	ARTIST_OR_COMPOSER:孟楠
查找完美主义这首歌	MUSIC_SEARCH	TITLE:完美主义
查找家乡美的歌词	MUSIC_SEARCH	TITLE:家乡美
查找寂寞的音乐	MUSIC_SEARCH	GENRE:寂寞的音乐
查找将军这首歌	MUSIC_SEARCH	TITLE:将军
查找布达拉的歌词吧	MUSIC_SEARCH	TITLE:布达拉
查找帕瓦罗蒂的歌剧	MUSIC_SEARCH	ARTIST_OR_COMPOSER:帕瓦罗蒂	GENRE:歌剧
查找庄心妍的歌曲	MUSIC_SEARCH	ARTIST_OR_COMPOSER:庄心妍
查找忍者这首歌	MUSIC_SEARCH	TITLE:忍者
查找忘不记里面有哪几首歌曲	MUSIC_SEARCH	ALBUMNAME:忘不记
查找快乐人间这首歌	MUSIC_SEARCH	TITLE:快乐人间
查找想你的距离这个专辑里面的所有歌曲	MUSIC_SEARCH	ALBUMNAME:想你的距离
查找我是你的谁的歌曲信息	MUSIC_SEARCH	TITLE:我是你的谁
查找我是海棠这个专辑	MUSIC_SEARCH	ALBUMNAME:我是海棠
查找我是海雅谷慕这个专辑	MUSIC_SEARCH	ALBUMNAME:我是海雅谷慕
查找我的地盘这首歌	MUSIC_SEARCH	TITLE:我的地盘
查找我的未来式的专辑	MUSIC_SEARCH	TITLE:我的未来式
查找我的歌声里	MUSIC_SEARCH	TITLE:我的歌声里
查找我的歌声里这首歌曲	MUSIC_SEARCH	TITLE:我的歌声里
查找所有六十年代的歌曲	MUSIC_SEARCH	year:六十年代
查找所有汪峰的歌	MUSIC_SEARCH	ARTIST_OR_COMPOSER:汪峰
查找扯这首歌	MUSIC_SEARCH	TITLE:扯
查找把爱说出来的歌曲信息	MUSIC_SEARCH	TITLE:把爱说出来
查找拉锯战的专辑	MUSIC_SEARCH	TITLE:拉锯战
查找拾伍这个专辑	MUSIC_SEARCH	ALBUMNAME:拾伍
查找摇滚乐	MUSIC_SEARCH	GENRE:摇滚乐
查找无双这首歌	MUSIC_SEARCH	TITLE:无双
查找无处不在的发行日期	MUSIC_SEARCH	ALBUMNAME:无处不在
查找明天再说这首歌的下载量	MUSIC_SEARCH	TITLE:明天再说
查找有你就够了的评论怎么样	MUSIC_SEARCH	TITLE:有你就够了
查找未完成的专辑	MUSIC_SEARCH	TITLE:未完成
查找未来的未来这首歌	MUSIC_SEARCH	TITLE:未来的未来
查找本草纲目这首歌	MUSIC_SEARCH	TITLE:本草纲目
查找杰伦里面的歌曲的名字	MUSIC_SEARCH	ALBUMNAME:杰伦
查找梁祝下世传奇的销量	MUSIC_SEARCH	ALBUMNAME:梁祝下世传奇
查找梁静茹的歌曲	MUSIC_SEARCH	ARTIST_OR_COMPOSER:梁静茹
查找欧美经典歌曲	MUSIC_SEARCH	GENRE:欧美经典歌曲
查找歌曲一个人	MUSIC_SEARCH	TITLE:一个人
查找歌曲一个旅人	MUSIC_SEARCH	TITLE:一个旅人
查找歌曲一滴眼泪	MUSIC_SEARCH	TITLE:一滴眼泪
查找歌曲一起嗌是什么时候发行的	MUSIC_SEARCH	TITLE:一起嗌
查找歌曲今天等我来	MUSIC_SEARCH	TITLE:今天等我来
查找歌曲倾城	MUSIC_SEARCH	TITLE:倾城
查找歌曲单车	MUSIC_SEARCH	TITLE:单车
查找歌曲天下无双	MUSIC_SEARCH	TITLE:天下无双
查找歌曲姑娘抛弃我是什么时候发行的	MUSIC_SEARCH	TITLE:姑娘抛弃我
查找歌曲当这地球没有花	MUSIC_SEARCH	TITLE:当这地球没有花
查找歌曲我杯茶	MUSIC_SEARCH	TITLE:我杯茶
查找歌曲我的快乐时代	MUSIC_SEARCH	TITLE:我的快乐时代
查找歌曲我让你走了是什么时候发行的	MUSIC_SEARCH	TITLE:我让你走了
查找歌曲改造人	MUSIC_SEARCH	TITLE:改造人
查找歌曲每一个明天	MUSIC_SEARCH	TITLE:每一个明天
查找歌曲浮夸	MUSIC_SEARCH	TITLE:浮夸
查找歌曲湘江的笔画是什么时候发行的	MUSIC_SEARCH	TITLE:湘江的笔画
查找歌曲滚	MUSIC_SEARCH	TITLE:滚
查找歌曲漂亮小姐	MUSIC_SEARCH	TITLE:漂亮小姐
查找歌曲爱是怀疑	MUSIC_SEARCH	TITLE:爱是怀疑
查找歌曲独居动物	MUSIC_SEARCH	TITLE:独居动物
查找歌曲稳稳的幸福	MUSIC_SEARCH	TITLE:稳稳的幸福
查找歌曲缠绵游戏	MUSIC_SEARCH	TITLE:缠绵游戏
查找歌曲苦瓜	MUSIC_SEARCH	TITLE:苦瓜
查找歌曲葡萄成熟时	MUSIC_SEARCH	TITLE:葡萄成熟时
查找歌曲讲男讲女	MUSIC_SEARCH	TITLE:讲男讲女
查找歌曲转机	MUSIC_SEARCH	TITLE:转机
查找歌曲还有什么可以送给你	MUSIC_SEARCH	TITLE:还有什么可以送给你
查找歌曲遇见了你	MUSIC_SEARCH	TITLE:遇见了你
查找歌曲非走不可	MUSIC_SEARCH	TITLE:非走不可
查找歌曲黄金时代	MUSIC_SEARCH	TITLE:黄金时代
查找永不分离的歌词	MUSIC_SEARCH	TITLE:永不分离
查找永夜这首歌	MUSIC_SEARCH	TITLE:永夜
查找永远不回头的专辑	MUSIC_SEARCH	TITLE:永远不回头
查找永远的永远里的日文歌	MUSIC_SEARCH	GENRE:日文歌	ALBUMNAME:永远的永远
查找汉语歌曲	MUSIC_SEARCH	GENRE:汉语歌曲
查找流浪诗人这首歌	MUSIC_SEARCH	TITLE:流浪诗人
查找熊猫与傻瓜的歌词	MUSIC_SEARCH	TITLE:熊猫与傻瓜
查找爱上一个人这首歌	MUSIC_SEARCH	TITLE:爱上一个人
查找爱情在香港转机这首歌	MUSIC_SEARCH	TITLE:爱情在香港转机
查找爱我别走这首歌	MUSIC_SEARCH	TITLE:爱我别走
查找爱的筹码这个专辑	MUSIC_SEARCH	ALBUMNAME:爱的筹码
查找爵士乐	MUSIC_SEARCH	GENRE:爵士乐
查找牛仔很忙	MUSIC_SEARCH	TITLE:牛仔很忙
查找牛仔很忙这个歌曲	MUSIC_SEARCH	TITLE:牛仔很忙
查找王菲的歌	MUSIC_SEARCH	ARTIST_OR_COMPOSER:王菲
查找珊瑚海这首歌	MUSIC_SEARCH	TITLE:珊瑚海
查找画沙这首歌	MUSIC_SEARCH	TITLE:画沙
查找疗伤烧肉粽这首歌	MUSIC_SEARCH	TITLE:疗伤烧肉粽
查找疯了的歌词吧	MUSIC_SEARCH	TITLE:疯了
查找痛爱这首歌	MUSIC_SEARCH	TITLE:痛爱
查找百战英雄这首歌的歌手	MUSIC_SEARCH	TITLE:百战英雄
查找盛开里面有哪几首歌	MUSIC_SEARCH	ALBUMNAME:盛开
查找看我七十二变	MUSIC_SEARCH	TITLE:看我七十二变
查找看我七十二变这支歌	MUSIC_SEARCH	TITLE:看我七十二变
查找眼耳口鼻在哪个专辑	MUSIC_SEARCH	TITLE:眼耳口鼻
查找瞬间永恒这首歌的下载量	MUSIC_SEARCH	TITLE:瞬间永恒
查找神奇这首歌的下载量	MUSIC_SEARCH	TITLE:神奇
查找第二人生这张专辑	MUSIC_SEARCH	ALBUMNAME:第二人生
查找第二人生里面的所有歌曲	MUSIC_SEARCH	ALBUMNAME:第二人生
查找等等里面有哪几首歌曲	MUSIC_SEARCH	ALBUMNAME:等等
查找简单爱这首歌	MUSIC_SEARCH	TITLE:简单爱
查找紧紧的拥抱你的歌词吧	MUSIC_SEARCH	TITLE:紧紧的拥抱你
查找经典歌曲	MUSIC_SEARCH	GENRE:经典歌曲
查找经典老歌歌曲	MUSIC_SEARCH	GENRE:经典老歌
查找给爱人的倾诉这首歌的歌手	MUSIC_SEARCH	TITLE:给爱人的倾诉
查找网上的京剧	MUSIC_SEARCH	GENRE:京剧
查找美好里面有哪几首歌	MUSIC_SEARCH	ALBUMNAME:美好
查找范特西	MUSIC_SEARCH	ALBUMNAME:范特西
查找范特西专辑	MUSIC_SEARCH	ALBUMNAME:范特西
查找范特西的发行日期	MUSIC_SEARCH	ALBUMNAME:范特西
查找范特西里面的歌曲的名字	MUSIC_SEARCH	ALBUMNAME:范特西
查找蜗牛这支歌的信息	MUSIC_SEARCH	TITLE:蜗牛
查找蜗牛这首歌的歌词	MUSIC_SEARCH	TITLE:蜗牛
查找见你好吗里的日文歌	MUSIC_SEARCH	GENRE:日文歌	ALBUMNAME:见你好吗
查找说唱音乐	MUSIC_SEARCH	GENRE:说唱音乐
查找谢幕里面的歌曲的名字	MUSIC_SEARCH	ALBUMNAME:谢幕
查找赵晗的歌曲	MUSIC_SEARCH	ARTIST_OR_COMPOSER:赵晗
查找超有感的专辑的信息吧	MUSIC_SEARCH	ALBUMNAME:超有感
查找轻音乐	MUSIC_SEARCH	GENRE:轻音乐
查找这两年的新歌	MUSIC_SEARCH	year:这两年
查找这宅无处不在 个专辑	MUSIC_SEARCH	ALBUMNAME:宅无处不在
查找迷迭香这首歌	MUSIC_SEARCH	TITLE:迷迭香
查找逃兵在哪个专辑	MUSIC_SEARCH	TITLE:逃兵
查找那些别人要的这首歌	MUSIC_SEARCH	TITLE:那些别人要的
查找郭静唱过的歌曲	MUSIC_SEARCH	ARTIST_OR_COMPOSER:郭静
查找钢琴曲	MUSIC_SEARCH	GENRE:钢琴曲
查找陈奕迅的歌	MUSIC_SEARCH	ARTIST_OR_COMPOSER:陈奕迅
查找陈慧娴的歌	MUSIC_SEARCH	ARTIST_OR_COMPOSER:陈慧娴
查找陪我去流浪里面有哪几首歌	MUSIC_SEARCH	ALBUMNAME:陪我去流浪
查找雨下一整晚这首歌	MUSIC_SEARCH	TITLE:雨下一整晚
查找霍元甲这首歌	MUSIC_SEARCH	TITLE:霍元甲
查找青花瓷这首歌	MUSIC_SEARCH	TITLE:青花瓷
查找非主流的音乐	MUSIC_SEARCH	GENRE:非主流
查找音乐新浪潮这个专辑	MUSIC_SEARCH	ALBUMNAME:音乐新浪潮
查找飘移的评论怎么样	MUSIC_SEARCH	TITLE:飘移
查找魔杰座	MUSIC_SEARCH	ALBUMNAME:魔杰座
查找魔杰座专辑	MUSIC_SEARCH	ALBUMNAME:魔杰座
查找鲜花陪伴你在哪个专辑	MUSIC_SEARCH	TITLE:鲜花陪伴你
查找麦田捕手的销量	MUSIC_SEARCH	ALBUMNAME:麦田捕手
查找黑色橙子这个专辑	MUSIC_SEARCH	ALBUMNAME:黑色橙子
查找默默的歌曲信息	MUSIC_SEARCH	TITLE:默默
柯以敏的天真的双眼	MUSIC_SEARCH	ARTIST_OR_COMPOSER:柯以敏	TITLE:天真的双眼
格莱美奖的情况	MUSIC_SEARCH
桐花里面有什么中文歌曲	MUSIC_SEARCH	GENRE:中文歌曲	ALBUMNAME:桐花
桐花里面有哪个年代的歌曲	MUSIC_SEARCH	ALBUMNAME:桐花
梁一贞唱了每次都想呼喊你的名字吗	MUSIC_SEARCH	ARTIST_OR_COMPOSER:梁一贞	TITLE:每次都想呼喊你的名字
梁家辉的守护神	MUSIC_SEARCH	ARTIST_OR_COMPOSER:梁家辉	TITLE:守护神
梁浩贤的专辑列表	MUSIC_SEARCH	ARTIST_OR_COMPOSER:梁浩贤
梁祝下世传奇是什么时候发行的	MUSIC_SEARCH	ALBUMNAME:梁祝下世传奇
梁祝下世传奇这个唱片最近很火么	MUSIC_SEARCH	ALBUMNAME:梁祝下世传奇
梁祝下世传奇里面是不是都是七十年代的歌	MUSIC_SEARCH	year:七十年代	ALBUMNAME:梁祝下世传奇
梅艳芳的那首昨天的太阳	MUSIC_SEARCH	ARTIST_OR_COMPOSER:梅艳芳	TITLE:昨天的太阳
梦一场这首歌比较好听么	MUSIC_SEARCH	TITLE:梦一场
梦中情人这个专辑怎么样	MUSIC_SEARCH	ALBUMNAME:梦中情人
梦仍是一样用在哪些电影里	MUSIC_SEARCH	TITLE:梦仍是一样
梦扬专辑的信息	MUSIC_SEARCH	ARTIST_OR_COMPOSER:梦扬
梦游计这个专辑怎么样	MUSIC_SEARCH	ALBUMNAME:梦游计
梦话的作曲是谁	MUSIC_SEARCH	TITLE:梦话
梦里花这个专辑怎么样	MUSIC_SEARCH	ALBUMNAME:梦里花
椎名林檎唱过爱应该快乐吗	MUSIC_SEARCH	ARTIST_OR_COMPOSER:椎名林檎	TITLE:爱应该快乐
欧美最流行的歌曲是什么	MUSIC_SEARCH	GENRE:欧美
欧美的歌手都有谁	MUSIC_SEARCH	GENRE:欧美
欧若拉这个专辑怎么样	MUSIC_SEARCH	ALBUMNAME:欧若拉
歌声里的回忆这个专辑是谁做的	MUSIC_SEARCH	ALBUMNAME:歌声里的回忆
歌曲一个爱上浪漫的人的发行日期	MUSIC_SEARCH	TITLE:一个爱上浪漫的人
歌曲丁香雨怎么样	MUSIC_SEARCH	TITLE:丁香雨
歌曲七友的主题是什么	MUSIC_SEARCH	TITLE:七友
歌曲七号公园怎么样	MUSIC_SEARCH	TITLE:七号公园
歌曲万众爱戴的主题是什么	MUSIC_SEARCH	TITLE:万众爱戴
歌曲不后悔的决定有什么样的曲风元素	MUSIC_SEARCH	TITLE:不后悔的决定
歌曲不煽情怎么样	MUSIC_SEARCH	TITLE:不煽情
歌曲不能这样活怎么样	MUSIC_SEARCH	TITLE:不能这样活
歌曲不要带她走的发行日期	MUSIC_SEARCH	TITLE:不要带她走
歌曲世界需要热心肠怎么样	MUSIC_SEARCH	TITLE:世界需要热心肠
歌曲东边日出西边雨怎么样	MUSIC_SEARCH	TITLE:东边日出西边雨
歌曲也许怎么样	MUSIC_SEARCH	TITLE:也许
歌曲亚洲雄风怎么样	MUSIC_SEARCH	TITLE:亚洲雄风
歌曲伴虎怎么样	MUSIC_SEARCH	TITLE:伴虎
歌曲你是一面旗帜怎么样	MUSIC_SEARCH	TITLE:你是一面旗帜
歌曲你的心里还有谁是什么时候发行的	MUSIC_SEARCH	TITLE:你的心里还有谁
歌曲你若成风怎么样	MUSIC_SEARCH	TITLE:你若成风
歌曲光明有什么样的曲风元素	MUSIC_SEARCH	TITLE:光明
歌曲全球变冷怎么样	MUSIC_SEARCH	TITLE:全球变冷
歌曲共有的家园怎么样	MUSIC_SEARCH	TITLE:共有的家园
歌曲内线怎么样	MUSIC_SEARCH	TITLE:内线
歌曲再没有你的温柔有什么样的曲风元素	MUSIC_SEARCH	TITLE:再没有你的温柔
歌曲凤凰于飞怎么样	MUSIC_SEARCH	TITLE:凤凰于飞
歌曲别以为我不会走是谁的	MUSIC_SEARCH	TITLE:别以为我不会走
歌曲前面的内容是什么	MUSIC_SEARCH	TITLE:前面
歌曲北京人在纽约怎么样	MUSIC_SEARCH	TITLE:北京人在纽约
歌曲医生怎么样	MUSIC_SEARCH	TITLE:医生
歌曲千万次的问怎么样	MUSIC_SEARCH	TITLE:千万次的问
歌曲千百度怎么样	MUSIC_SEARCH	TITLE:千百度
歌曲半城烟沙怎么样	MUSIC_SEARCH	TITLE:半城烟沙
歌曲单人旅途怎么样	MUSIC_SEARCH	TITLE:单人旅途
歌曲去者怎么样	MUSIC_SEARCH	TITLE:去者
歌曲双人旁怎么样	MUSIC_SEARCH	TITLE:双人旁
歌曲叹服怎么样	MUSIC_SEARCH	TITLE:叹服
歌曲同一个世界同一个梦想怎么样	MUSIC_SEARCH	TITLE:同一个世界同一个梦想
歌曲同一个世界，同一个梦想怎么样	MUSIC_SEARCH	TITLE:同一个世界，同一个梦想
歌曲四月物语吸收了什么曲风元素	MUSIC_SEARCH	TITLE:四月物语
歌曲在那不遥远的地方怎么样	MUSIC_SEARCH	TITLE:在那不遥远的地方
歌曲坏习惯的主题是什么	MUSIC_SEARCH	TITLE:坏习惯
歌曲坏孩子怎么样	MUSIC_SEARCH	TITLE:坏孩子
歌曲城府怎么样	MUSIC_SEARCH	TITLE:城府
歌曲多余的解释怎么样	MUSIC_SEARCH	TITLE:多余的解释
歌曲大爱怎么样	MUSIC_SEARCH	TITLE:大爱
歌曲天使怎么样	MUSIC_SEARCH	TITLE:天使
歌曲天地在我心怎么样	MUSIC_SEARCH	TITLE:天地在我心
歌曲天天等的风格是哪里的	MUSIC_SEARCH	TITLE:天天等
歌曲如果当时怎么样	MUSIC_SEARCH	TITLE:如果当时
歌曲安徒生不后悔怎么样	MUSIC_SEARCH	TITLE:安徒生不后悔
歌曲安琪怎么样	MUSIC_SEARCH	TITLE:安琪
歌曲家园怎么样	MUSIC_SEARCH	TITLE:家园
歌曲对话老师怎么样	MUSIC_SEARCH	TITLE:对话老师
歌曲少年壮志不言愁怎么样	MUSIC_SEARCH	TITLE:少年壮志不言愁
歌曲尘世美怎么样	MUSIC_SEARCH	TITLE:尘世美
歌曲布瓜的世界有什么样的曲风元素	MUSIC_SEARCH	TITLE:布瓜的世界
歌曲带轱辘的摇篮怎么样	MUSIC_SEARCH	TITLE:带轱辘的摇篮
歌曲幻听怎么样	MUSIC_SEARCH	TITLE:幻听
歌曲庐州月怎么样	MUSIC_SEARCH	TITLE:庐州月
歌曲弯弯的月亮怎么样	MUSIC_SEARCH	TITLE:弯弯的月亮
歌曲微博控怎么样	MUSIC_SEARCH	TITLE:微博控
歌曲微笑的起点的内容是什么	MUSIC_SEARCH	TITLE:微笑的起点
歌曲心中的太阳怎么样	MUSIC_SEARCH	TITLE:心中的太阳
歌曲心痛你的过去怎么样	MUSIC_SEARCH	TITLE:心痛你的过去
歌曲心雨怎么样	MUSIC_SEARCH	TITLE:心雨
歌曲恋人勿近的风格是哪里的	MUSIC_SEARCH	TITLE:恋人勿近
歌曲情怨怎么样	MUSIC_SEARCH	TITLE:情怨
歌曲想象之中怎么样	MUSIC_SEARCH	TITLE:想象之中
歌曲慈悲吸收了什么曲风元素	MUSIC_SEARCH	TITLE:慈悲
歌曲我很喜欢怎么样	MUSIC_SEARCH	TITLE:我很喜欢
歌曲我想牵着你的手怎么样	MUSIC_SEARCH	TITLE:我想牵着你的手
歌曲我无所谓怎么样	MUSIC_SEARCH	TITLE:我无所谓
歌曲我要轻问是不是很火啊	MUSIC_SEARCH	TITLE:我要轻问
歌曲抽离怎么样	MUSIC_SEARCH	TITLE:抽离
歌曲拆东墙怎么样	MUSIC_SEARCH	TITLE:拆东墙
歌曲摇头玩怎么样	MUSIC_SEARCH	TITLE:摇头玩
歌曲放逐爱情是不是很火啊	MUSIC_SEARCH	TITLE:放逐爱情
歌曲散场电影怎么样	MUSIC_SEARCH	TITLE:散场电影
歌曲敬酒不吃怎么样	MUSIC_SEARCH	TITLE:敬酒不吃
歌曲断桥残雪怎么样	MUSIC_SEARCH	TITLE:断桥残雪
歌曲日本你听着是什么时候发行的	MUSIC_SEARCH	TITLE:日本你听着
歌曲星座书上怎么样	MUSIC_SEARCH	TITLE:星座书上
歌曲春天里怎么样	MUSIC_SEARCH	TITLE:春天里
歌曲昨天下了一夜雨怎么样	MUSIC_SEARCH	TITLE:昨天下了一夜雨
歌曲有何不可怎么样	MUSIC_SEARCH	TITLE:有何不可
歌曲梦回的家乡怎么样	MUSIC_SEARCH	TITLE:梦回的家乡
歌曲毁人不倦怎么样	MUSIC_SEARCH	TITLE:毁人不倦
歌曲河山大好怎么样	MUSIC_SEARCH	TITLE:河山大好
歌曲河童是谁的	MUSIC_SEARCH	TITLE:河童
歌曲浅唱怎么样	MUSIC_SEARCH	TITLE:浅唱
歌曲清明雨上怎么样	MUSIC_SEARCH	TITLE:清明雨上
歌曲温情永远怎么样	MUSIC_SEARCH	TITLE:温情永远
歌曲满堂红怎么样	MUSIC_SEARCH	TITLE:满堂红
歌曲灰色头像怎么样	MUSIC_SEARCH	TITLE:灰色头像
歌曲爱之无奈怎么样	MUSIC_SEARCH	TITLE:爱之无奈
歌曲爱情怎么样	MUSIC_SEARCH	TITLE:爱情
歌曲爱情的主题是什么	MUSIC_SEARCH	TITLE:爱情
歌曲爱情里的眼泪怎么样	MUSIC_SEARCH	TITLE:爱情里的眼泪
歌曲爱我好吗吸收了什么曲风元素	MUSIC_SEARCH	TITLE:爱我好吗
歌曲爱的一生怎么样	MUSIC_SEARCH	TITLE:爱的一生
歌曲爱的寓言怎么样	MUSIC_SEARCH	TITLE:爱的寓言
歌曲爱那么重是谁的	MUSIC_SEARCH	TITLE:爱那么重
歌曲猪头哥哥是什么时候发行的	MUSIC_SEARCH	TITLE:猪头哥哥
歌曲玫瑰花的葬礼怎么样	MUSIC_SEARCH	TITLE:玫瑰花的葬礼
歌曲生活就是这么怪是谁的	MUSIC_SEARCH	TITLE:生活就是这么怪
歌曲白马非马怎么样	MUSIC_SEARCH	TITLE:白马非马
歌曲相约如梦怎么样	MUSIC_SEARCH	TITLE:相约如梦
歌曲看不见的风景怎么样	MUSIC_SEARCH	TITLE:看不见的风景
歌曲磨刀老头怎么样	MUSIC_SEARCH	TITLE:磨刀老头
歌曲离不开你怎么样	MUSIC_SEARCH	TITLE:离不开你
歌曲离别曲是不是很火啊	MUSIC_SEARCH	TITLE:离别曲
歌曲笑着哭怎么样	MUSIC_SEARCH	TITLE:笑着哭
歌曲素颜怎么样	MUSIC_SEARCH	TITLE:素颜
歌曲绿叶对根的情谊怎么样	MUSIC_SEARCH	TITLE:绿叶对根的情谊
歌曲胡萝卜须怎么样	MUSIC_SEARCH	TITLE:胡萝卜须
歌曲菩萨蛮怎么样	MUSIC_SEARCH	TITLE:菩萨蛮
歌曲落花流水的内容是什么	MUSIC_SEARCH	TITLE:落花流水
歌曲蒙古姑娘怎么样	MUSIC_SEARCH	TITLE:蒙古姑娘
歌曲装糊涂怎么样	MUSIC_SEARCH	TITLE:装糊涂
歌曲认错怎么样	MUSIC_SEARCH	TITLE:认错
歌曲让我们同行怎么样	MUSIC_SEARCH	TITLE:让我们同行
歌曲说你没用的风格是哪里的	MUSIC_SEARCH	TITLE:说你没用
歌曲谜城的内容是什么	MUSIC_SEARCH	TITLE:谜城
歌曲谢谢你的爱是不是很火啊	MUSIC_SEARCH	TITLE:谢谢你的爱
歌曲越来越好是什么时候发行的	MUSIC_SEARCH	TITLE:越来越好
歌曲边界城市吸收了什么曲风元素	MUSIC_SEARCH	TITLE:边界城市
歌曲违章动物怎么样	MUSIC_SEARCH	TITLE:违章动物
歌曲金包银的风格是哪里的	MUSIC_SEARCH	TITLE:金包银
歌曲闺蜜怎么样	MUSIC_SEARCH	TITLE:闺蜜
歌曲阿尔卑斯山的小雨怎么样	MUSIC_SEARCH	TITLE:阿尔卑斯山的小雨
歌曲降温怎么样	MUSIC_SEARCH	TITLE:降温
歌曲雨一直下的发行日期	MUSIC_SEARCH	TITLE:雨一直下
歌曲青怎么样	MUSIC_SEARCH	TITLE:青
歌曲飞花歌的发行日期	MUSIC_SEARCH	TITLE:飞花歌
歌曲魔兽世界怎么样	MUSIC_SEARCH	TITLE:魔兽世界
歌曲黑白相纸怎么样	MUSIC_SEARCH	TITLE:黑白相纸
歌曲齐天大圣怎么样	MUSIC_SEARCH	TITLE:齐天大圣
此生为了美属于什么音乐	MUSIC_SEARCH	TITLE:此生为了美
死守的专辑是什么时候发行的	MUSIC_SEARCH	TITLE:死守
每一个晚上的作曲家是谁	MUSIC_SEARCH	TITLE:每一个晚上
每天爱你多一些粤语是哪位著名歌手唱的么	MUSIC_SEARCH	TITLE:每天爱你多一些粤语
毕业的音乐播放列表	MUSIC_SEARCH	GENRE:毕业的音乐
毕夏唱过多少首歌	MUSIC_SEARCH	ARTIST_OR_COMPOSER:毕夏
民雄播放列表	MUSIC_SEARCH	ARTIST_OR_COMPOSER:民雄
水涟漪是什么时候的歌	MUSIC_SEARCH	TITLE:水涟漪
永恒有哪几个歌手演唱过	MUSIC_SEARCH	TITLE:永恒
永远怀念你这首歌有没有吸收拉丁美洲的元素	MUSIC_SEARCH	TITLE:永远怀念你
永远的宝贝现在有多流行	MUSIC_SEARCH	TITLE:永远的宝贝
永远的永远是谁的专辑	MUSIC_SEARCH	ALBUMNAME:永远的永远
永远的永远是阿尔法音乐制作的么	MUSIC_SEARCH	ALBUMNAME:永远的永远
永远的第一天用在哪些电影里	MUSIC_SEARCH	TITLE:永远的第一天
永远的蝴蝶这首歌流行么	MUSIC_SEARCH	TITLE:永远的蝴蝶
求做你的男人这首歌	MUSIC_SEARCH	TITLE:做你的男人
求婚是哪个著名作词家写的	MUSIC_SEARCH	TITLE:求婚
求恭喜发财这首歌	MUSIC_SEARCH	TITLE:恭喜发财
求飚车这首歌	MUSIC_SEARCH	TITLE:飚车
求黑白照这首歌	MUSIC_SEARCH	TITLE:黑白照
江华的那首极爱自己	MUSIC_SEARCH	ARTIST_OR_COMPOSER:江华	TITLE:极爱自己
江欣慈唱了超人不在家吗	MUSIC_SEARCH	ARTIST_OR_COMPOSER:江欣慈	TITLE:超人不在家
江玲唱的最重要的小事	MUSIC_SEARCH	ARTIST_OR_COMPOSER:江玲	TITLE:最重要的小事
江美琪播放列表	MUSIC_SEARCH	ARTIST_OR_COMPOSER:江美琪
池贤宇的那首转性	MUSIC_SEARCH	ARTIST_OR_COMPOSER:池贤宇	TITLE:转性
汤潮专辑的信息	MUSIC_SEARCH	ARTIST_OR_COMPOSER:汤潮
汪达最新专辑是什么	MUSIC_SEARCH	ARTIST_OR_COMPOSER:汪达
沂蒙颂是谁演唱的	MUSIC_SEARCH	TITLE:沂蒙颂
沉默剧被谁翻唱过	MUSIC_SEARCH	TITLE:沉默剧
沙宝亮的歌声怎么样	MUSIC_SEARCH	ARTIST_OR_COMPOSER:沙宝亮
沙宝亮的歌曲怎么样	MUSIC_SEARCH	ARTIST_OR_COMPOSER:沙宝亮
沙尘暴是谁作的词	MUSIC_SEARCH	TITLE:沙尘暴
没锁门是哪个年代创作的	MUSIC_SEARCH	TITLE:没锁门
河这首歌适不适合年轻人听	MUSIC_SEARCH	TITLE:河
油画里的情人节的演唱家是谁	MUSIC_SEARCH	TITLE:油画里的情人节
沿途有你是哪个电影里的歌曲么	MUSIC_SEARCH	TITLE:沿途有你
法兰西的浪漫现在是不是很流行	MUSIC_SEARCH	TITLE:法兰西的浪漫
泡面的幸福这首歌比较好听么	MUSIC_SEARCH	TITLE:泡面的幸福
泪光雨这首歌谁演唱过	MUSIC_SEARCH	TITLE:泪光雨
泰勒斯威夫特唱过几首歌	MUSIC_SEARCH	ARTIST_OR_COMPOSER:泰勒斯威夫特
泰勒的那首哭过以后	MUSIC_SEARCH	ARTIST_OR_COMPOSER:泰勒	TITLE:哭过以后
泰语歌播放列表	MUSIC_SEARCH	GENRE:泰语歌
泰语歌曲多不多	MUSIC_SEARCH	GENRE:泰语歌曲
泼水节这首歌很有名么	MUSIC_SEARCH	TITLE:泼水节
洛许专辑的信息	MUSIC_SEARCH	ARTIST_OR_COMPOSER:洛许
海阔天空是个什么类型的专辑	MUSIC_SEARCH	ALBUMNAME:海阔天空
海阔天空里面歌曲的风格是什么	MUSIC_SEARCH	ALBUMNAME:海阔天空
深度接触乐队唱的掌声响起来	MUSIC_SEARCH	ARTIST_OR_COMPOSER:深度接触乐队	TITLE:掌声响起来
渔娘这首歌怎么样	MUSIC_SEARCH	TITLE:渔娘
温柔的慈悲是什么年代的歌曲	MUSIC_SEARCH	TITLE:温柔的慈悲
渴望晨曦的女孩这首歌在什么分类里	MUSIC_SEARCH	TITLE:渴望晨曦的女孩
漂流瓶这个歌由谁演唱过	MUSIC_SEARCH	TITLE:漂流瓶
潘多拉这个专辑怎么样	MUSIC_SEARCH	ALBUMNAME:潘多拉
潘晓峰最新专辑是什么	MUSIC_SEARCH	ARTIST_OR_COMPOSER:潘晓峰
火力全开是个什么类型的专辑	MUSIC_SEARCH	ALBUMNAME:火力全开
火力全开是谁发行的专辑	MUSIC_SEARCH	ALBUMNAME:火力全开
火力全开这个专辑出自哪个歌手	MUSIC_SEARCH	ALBUMNAME:火力全开
火风的那首绯闻男女	MUSIC_SEARCH	ARTIST_OR_COMPOSER:火风	TITLE:绯闻男女
灯红酒绿属于几十年代的歌曲	MUSIC_SEARCH	TITLE:灯红酒绿
烟花江畔这首歌属于什么曲风	MUSIC_SEARCH	TITLE:烟花江畔
热身的原版是什么歌	MUSIC_SEARCH	TITLE:热身
燕妮唱过的那天	MUSIC_SEARCH	ARTIST_OR_COMPOSER:燕妮	TITLE:那天
爆米花被谁翻唱过	MUSIC_SEARCH	TITLE:爆米花
爱不到的滋味被谁演唱过	MUSIC_SEARCH	TITLE:爱不到的滋味
爱与不爱之间是一首新歌么	MUSIC_SEARCH	TITLE:爱与不爱之间
爱到才知痛这首歌是谁唱的	MUSIC_SEARCH	TITLE:爱到才知痛
爱可以问谁的作词家叫什么名字	MUSIC_SEARCH	TITLE:爱可以问谁
爱在他乡这首歌是哪个歌手的	MUSIC_SEARCH	TITLE:爱在他乡
爱在心中说不出口的原唱是谁	MUSIC_SEARCH	TITLE:爱在心中说不出口
爱怎么了断在哪个专辑里	MUSIC_SEARCH	TITLE:爱怎么了断
爱情不只是很好听么	MUSIC_SEARCH	TITLE:爱情不只是
爱情习作是哪个国家的歌曲	MUSIC_SEARCH	TITLE:爱情习作
爱情抗体这首歌的评论怎么样	MUSIC_SEARCH	TITLE:爱情抗体
爱情玛奇朵是什么年代的歌曲	MUSIC_SEARCH	TITLE:爱情玛奇朵
爱情的房子是哪个电视剧的片头曲	MUSIC_SEARCH	TITLE:爱情的房子
爱我还要背叛我多长	MUSIC_SEARCH	TITLE:爱我还要背叛我
爱戴唱过的神枪手	MUSIC_SEARCH	ARTIST_OR_COMPOSER:爱戴	TITLE:神枪手
爱才是个什么类的歌曲	MUSIC_SEARCH	TITLE:爱才
爱无界的最曲家是谁	MUSIC_SEARCH	TITLE:爱无界
爱是谁的错有几个小节	MUSIC_SEARCH	TITLE:爱是谁的错
爱杀死爱的最曲家是谁	MUSIC_SEARCH	TITLE:爱杀死爱
爱的力量这个专辑里是不是有十首歌	MUSIC_SEARCH	ALBUMNAME:爱的力量
爱的力量里面有什么中文歌曲	MUSIC_SEARCH	GENRE:中文歌曲	ALBUMNAME:爱的力量
爱的力量里面的曲风是什么	MUSIC_SEARCH	ALBUMNAME:爱的力量
爱的力量里面的歌曲都是哪几个歌手唱的	MUSIC_SEARCH	ALBUMNAME:爱的力量
爱的大游行这张专辑的发行公司是什么	MUSIC_SEARCH	ALBUMNAME:爱的大游行
爱的大游行里的歌曲主要是谁写的曲	MUSIC_SEARCH	ALBUMNAME:爱的大游行
爱的大游行里都有哪些歌	MUSIC_SEARCH	ALBUMNAME:爱的大游行
爱的大游行里面的曲风是什么	MUSIC_SEARCH	ALBUMNAME:爱的大游行
爱的奉献在哪个专辑里	MUSIC_SEARCH	TITLE:爱的奉献
爱的宣言这首歌的主题是什么	MUSIC_SEARCH	TITLE:爱的宣言
爱的真正重量的曲子是抄的哪首歌	MUSIC_SEARCH	TITLE:爱的真正重量
爱的筹码这个唱片最近很火么	MUSIC_SEARCH	ALBUMNAME:爱的筹码
爱的筹码这张专辑下面有什么曲目	MUSIC_SEARCH	ALBUMNAME:爱的筹码
爱的筹码这张专辑最近很火么	MUSIC_SEARCH	ALBUMNAME:爱的筹码
爱的翅膀这首曲子被下载过多少次	MUSIC_SEARCH	TITLE:爱的翅膀
爱的越深伤的越深是什么类型的歌曲啊	MUSIC_SEARCH	TITLE:爱的越深伤的越深
爱的进行式什么时候发行	MUSIC_SEARCH	ALBUMNAME:爱的进行式
爱的进行式卖多少钱	MUSIC_SEARCH	ALBUMNAME:爱的进行式
爱的进行式去年的发行量是多少	MUSIC_SEARCH	year:去年	ALBUMNAME:爱的进行式
爱的进行式这张专辑几月几号发行的	MUSIC_SEARCH	ALBUMNAME:爱的进行式
爱笑的天使的作曲灵感来源于什么	MUSIC_SEARCH	TITLE:爱笑的天使
爱赢了里面有几首歌	MUSIC_SEARCH	ALBUMNAME:爱赢了
父亲节歌组	MUSIC_SEARCH	GENRE:父亲节
牛仔很忙这首歌是谁唱的	MUSIC_SEARCH	TITLE:牛仔很忙
牛嘉最新专辑是什么	MUSIC_SEARCH	ARTIST_OR_COMPOSER:牛嘉
牵手观姻是谁作的曲	MUSIC_SEARCH	TITLE:牵手观姻
特别的想念是哪个歌手专属的歌么	MUSIC_SEARCH	TITLE:特别的想念
狂悲狂喜这首歌有没有法语版	MUSIC_SEARCH	TITLE:狂悲狂喜
献给伟大的毛主席的曲风是什么	MUSIC_SEARCH	TITLE:献给伟大的毛主席
王依华新专辑	MUSIC_SEARCH	ARTIST_OR_COMPOSER:王依华
王冰洋的飞儿乐团	MUSIC_SEARCH	ARTIST_OR_COMPOSER:王冰洋	ALBUMNAME:飞儿乐团
王凡瑞的那首因为了解，所以分手	MUSIC_SEARCH	ARTIST_OR_COMPOSER:王凡瑞	TITLE:因为了解，所以分手
王十三这首歌在什么分类里	MUSIC_SEARCH	TITLE:王十三
王宇的歌是什么类型	MUSIC_SEARCH	ARTIST_OR_COMPOSER:王宇
王心凌的歌	MUSIC_SEARCH	ARTIST_OR_COMPOSER:王心凌
王心凌的歌曲	MUSIC_SEARCH	ARTIST_OR_COMPOSER:王心凌
王歌慧唱的你爱着他	MUSIC_SEARCH	ARTIST_OR_COMPOSER:王歌慧	TITLE:你爱着他
王菲2001这个专辑如何	MUSIC_SEARCH	ALBUMNAME:王菲2001
王菲的故事这个专辑如何	MUSIC_SEARCH	ALBUMNAME:王菲的故事
王菲的歌曲好不好听	MUSIC_SEARCH	ARTIST_OR_COMPOSER:王菲
王识贤最新专辑是什么	MUSIC_SEARCH	ARTIST_OR_COMPOSER:王识贤
王麟的拾伍	MUSIC_SEARCH	ARTIST_OR_COMPOSER:王麟	ALBUMNAME:拾伍
王默君唱的烟斗阿兄	MUSIC_SEARCH	ARTIST_OR_COMPOSER:王默君	TITLE:烟斗阿兄
玛莉雅新专辑	MUSIC_SEARCH	ARTIST_OR_COMPOSER:玛莉雅
玛蒂耶最新专辑是什么	MUSIC_SEARCH	ARTIST_OR_COMPOSER:玛蒂耶
玩世不恭是不是一个电影歌曲	MUSIC_SEARCH	GENRE:电影歌曲	TITLE:玩世不恭
现在就想见的人来自于什么年代	MUSIC_SEARCH	TITLE:现在就想见的人
现在最流行的是什么歌	MUSIC_SEARCH
玻璃鞋的曲风是什么	MUSIC_SEARCH	TITLE:玻璃鞋
琵琶曲歌组	MUSIC_SEARCH	GENRE:琵琶曲
琵琶曲都有什么	MUSIC_SEARCH	GENRE:琵琶曲
甘愿是哪年首唱的	MUSIC_SEARCH	TITLE:甘愿
甘雅丹唱过的想你想断肠	MUSIC_SEARCH	ARTIST_OR_COMPOSER:甘雅丹	TITLE:想你想断肠
甜甜的这首歌好听么	MUSIC_SEARCH	TITLE:甜甜的
生命有一种绝对这首歌所在的专辑是什么时候发行的	MUSIC_SEARCH	TITLE:生命有一种绝对
生日卡片是由谁演唱得	MUSIC_SEARCH	TITLE:生日卡片
生日是什么风格的歌曲	MUSIC_SEARCH	TITLE:生日
甩不掉现在是不是很流行	MUSIC_SEARCH	TITLE:甩不掉
由卞进燮演唱的同步呼吸	MUSIC_SEARCH	ARTIST_OR_COMPOSER:卞进燮	TITLE:同步呼吸
由张皓演唱的幸福是什么	MUSIC_SEARCH	ARTIST_OR_COMPOSER:张皓	TITLE:幸福是什么
由梦幻塑胶机器演唱的爱得太多	MUSIC_SEARCH	ARTIST_OR_COMPOSER:梦幻塑胶机器	TITLE:爱得太多
由潘东文演唱的不唱	MUSIC_SEARCH	ARTIST_OR_COMPOSER:潘东文	TITLE:不唱
由祝钒刚演唱的爱不爱我	MUSIC_SEARCH	ARTIST_OR_COMPOSER:祝钒刚	TITLE:爱不爱我
由耿珞演唱的尚深的所在	MUSIC_SEARCH	ARTIST_OR_COMPOSER:耿珞	TITLE:尚深的所在
由舒高演唱的超友谊	MUSIC_SEARCH	ARTIST_OR_COMPOSER:舒高	TITLE:超友谊
由薰妮演唱的两只老虎	MUSIC_SEARCH	ARTIST_OR_COMPOSER:薰妮	TITLE:两只老虎
由阿才演唱的意难忘	MUSIC_SEARCH	ARTIST_OR_COMPOSER:阿才	TITLE:意难忘
由雷蕾演唱的飞鸟	MUSIC_SEARCH	ARTIST_OR_COMPOSER:雷蕾	TITLE:飞鸟
电视搜索丁咚	MUSIC_SEARCH	ARTIST_OR_COMPOSER:丁咚
电视搜索凯特	MUSIC_SEARCH	ARTIST_OR_COMPOSER:凯特
电视搜索周永恒	MUSIC_SEARCH	ARTIST_OR_COMPOSER:周永恒
电视搜索宋承宪	MUSIC_SEARCH	ARTIST_OR_COMPOSER:宋承宪
电视搜索张小英	MUSIC_SEARCH	ARTIST_OR_COMPOSER:张小英
电视搜索徐飞	MUSIC_SEARCH	ARTIST_OR_COMPOSER:徐飞
电视搜索纪佳松	MUSIC_SEARCH	ARTIST_OR_COMPOSER:纪佳松
电视搜索袁世海	MUSIC_SEARCH	ARTIST_OR_COMPOSER:袁世海
电视搜索金范龙	MUSIC_SEARCH	ARTIST_OR_COMPOSER:金范龙
电视搜索高登	MUSIC_SEARCH	ARTIST_OR_COMPOSER:高登
留恋来自于哪个专辑	MUSIC_SEARCH	TITLE:留恋
痴情不是一种罪过属于什么歌	MUSIC_SEARCH	TITLE:痴情不是一种罪过
登封造极这个专辑是谁做的	MUSIC_SEARCH	ALBUMNAME:登封造极
白光唱的下午茶	MUSIC_SEARCH	ARTIST_OR_COMPOSER:白光	TITLE:下午茶
白狐这首歌怎么样	MUSIC_SEARCH	TITLE:白狐
白色童话来自于什么年代	MUSIC_SEARCH	TITLE:白色童话
百万富翁是哪个著名作词家写的	MUSIC_SEARCH	TITLE:百万富翁
百姓才是头上天是作做的曲	MUSIC_SEARCH	TITLE:百姓才是头上天
皮皮是谁唱的	MUSIC_SEARCH	TITLE:皮皮
盛开在什么年代发行的	MUSIC_SEARCH	ALBUMNAME:盛开
盛开的歌曲风格是什么	MUSIC_SEARCH	ALBUMNAME:盛开
盛开这张专辑里有哪几首歌	MUSIC_SEARCH	ALBUMNAME:盛开
盛开里面有什么中文歌曲	MUSIC_SEARCH	GENRE:中文歌曲	ALBUMNAME:盛开
盛开里面有几首歌	MUSIC_SEARCH	ALBUMNAME:盛开
相认被谁演唱过	MUSIC_SEARCH	TITLE:相认
看一下RAP类型的音乐	MUSIC_SEARCH	GENRE:RAP
看一下chamber pop类型的音乐	MUSIC_SEARCH	GENRE:chamber pop
看一下classical pop类型的音乐	MUSIC_SEARCH	GENRE:classical pop
看一下dream-pop类型的音乐	MUSIC_SEARCH	GENRE:dream-pop
看一下前卫金属类型的音乐	MUSIC_SEARCH	GENRE:前卫金属
看一下华丽金属类型的音乐	MUSIC_SEARCH	GENRE:华丽金属
看一下古典音乐类型的音乐	MUSIC_SEARCH	GENRE:古典音乐
看一下天注定这个专辑	MUSIC_SEARCH	ALBUMNAME:天注定
看一下好样这个专辑	MUSIC_SEARCH	ALBUMNAME:好样
看一下工业金属类型的音乐	MUSIC_SEARCH	GENRE:工业金属
看一下平安是福这个专辑	MUSIC_SEARCH	ALBUMNAME:平安是福
看一下快乐最快这个专辑	MUSIC_SEARCH	ALBUMNAME:快乐最快
看一下恋恋祯琳这个专辑	MUSIC_SEARCH	ALBUMNAME:恋恋祯琳
看一下我一直走这个专辑	MUSIC_SEARCH	ALBUMNAME:我一直走
看一下我们结婚吧这个专辑	MUSIC_SEARCH	ALBUMNAME:我们结婚吧
看一下我就在你面前这个专辑	MUSIC_SEARCH	ALBUMNAME:我就在你面前
看一下我相信这个专辑	MUSIC_SEARCH	ALBUMNAME:我相信
看一下新典金属类型的音乐	MUSIC_SEARCH	GENRE:新典金属
看一下月到天心处这个专辑	MUSIC_SEARCH	ALBUMNAME:月到天心处
看一下未满这个专辑	MUSIC_SEARCH	ALBUMNAME:未满
看一下梦的天空这个专辑	MUSIC_SEARCH	ALBUMNAME:梦的天空
看一下波普类型的音乐	MUSIC_SEARCH	GENRE:波普
看一下流行金属类型的音乐	MUSIC_SEARCH	GENRE:流行金属
看一下爱的史诗这个专辑	MUSIC_SEARCH	ALBUMNAME:爱的史诗
看一下直到最后这个专辑	MUSIC_SEARCH	ALBUMNAME:直到最后
看一下纠结这个专辑	MUSIC_SEARCH	ALBUMNAME:纠结
看一下给爱这个专辑	MUSIC_SEARCH	ALBUMNAME:给爱
看一下让你猜这个专辑	MUSIC_SEARCH	ALBUMNAME:让你猜
看一下轻音乐类型的音乐	MUSIC_SEARCH	GENRE:轻音乐
看一下速度金属类型的音乐	MUSIC_SEARCH	GENRE:速度金属
看一下重金属类型的音乐	MUSIC_SEARCH	GENRE:重金属
看一下鞭击金属类型的音乐	MUSIC_SEARCH	GENRE:鞭击金属
看海里面的歌曲都是哪几个歌手唱的	MUSIC_SEARCH	ALBUMNAME:看海
看看IDo这首歌	MUSIC_SEARCH	TITLE:IDo
看看不可不信缘这首歌	MUSIC_SEARCH	TITLE:不可不信缘
看看冰雨这首歌	MUSIC_SEARCH	TITLE:冰雨
看看回来吧好吗这首歌	MUSIC_SEARCH	TITLE:回来吧好吗
看看校园歌曲	MUSIC_SEARCH	GENRE:校园歌曲
看看歌曲亲爱的妈妈	MUSIC_SEARCH	TITLE:亲爱的妈妈
看看歌曲同床	MUSIC_SEARCH	TITLE:同床
看看歌曲妈妈的脸	MUSIC_SEARCH	TITLE:妈妈的脸
看看歌曲影帝无用	MUSIC_SEARCH	TITLE:影帝无用
看看歌曲拥抱你	MUSIC_SEARCH	TITLE:拥抱你
看看歌曲拥抱到明天	MUSIC_SEARCH	TITLE:拥抱到明天
看看歌曲无情天	MUSIC_SEARCH	TITLE:无情天
看看歌曲无须担心	MUSIC_SEARCH	TITLE:无须担心
看看歌曲母亲	MUSIC_SEARCH	TITLE:母亲
看看歌曲永远寂寞	MUSIC_SEARCH	TITLE:永远寂寞
看看歌曲潮水	MUSIC_SEARCH	TITLE:潮水
看看歌曲等我	MUSIC_SEARCH	TITLE:等我
看看歌曲绝望的笑容这首歌	MUSIC_SEARCH	TITLE:绝望的笑容
看看歌曲还记得我吗	MUSIC_SEARCH	TITLE:还记得我吗
看看歌曲迷醉的双脸	MUSIC_SEARCH	TITLE:迷醉的双脸
看看汗这首歌	MUSIC_SEARCH	TITLE:汗
看看狠心的一课这首歌	MUSIC_SEARCH	TITLE:狠心的一课
看看甘心这首歌	MUSIC_SEARCH	TITLE:甘心
看看的士司机这首歌	MUSIC_SEARCH	TITLE:的士司机
看看真爱是苦味这首歌	MUSIC_SEARCH	TITLE:真爱是苦味
看看老夫妻这首歌	MUSIC_SEARCH	TITLE:老夫妻
看看舞照跳这首歌	MUSIC_SEARCH	TITLE:舞照跳
看看苦命梁祝这首歌	MUSIC_SEARCH	TITLE:苦命梁祝
看看萍水相逢这首歌	MUSIC_SEARCH	TITLE:萍水相逢
看看藕断丝连这首歌	MUSIC_SEARCH	TITLE:藕断丝连
看看魔鬼在恋爱这首歌	MUSIC_SEARCH	TITLE:魔鬼在恋爱
真爱只有你有几个小节	MUSIC_SEARCH	TITLE:真爱只有你
真爱每一天这首歌怎么样	MUSIC_SEARCH	TITLE:真爱每一天
真的用了心这首歌属于什么曲风	MUSIC_SEARCH	TITLE:真的用了心
眼睛在哪个专辑里	MUSIC_SEARCH	TITLE:眼睛
睫毛弯弯的歌词是什么	MUSIC_SEARCH	TITLE:睫毛弯弯
石文唱了无言的温柔吗	MUSIC_SEARCH	ARTIST_OR_COMPOSER:石文	TITLE:无言的温柔
祝你快乐的歌词	MUSIC_SEARCH	TITLE:祝你快乐
祝福祖国算不算是比较非主流的音乐	MUSIC_SEARCH	GENRE:非主流	TITLE:祝福祖国
神化这首歌是什么分类	MUSIC_SEARCH	TITLE:神化
神秘嘉宾是周杰伦的专辑么	MUSIC_SEARCH	ARTIST_OR_COMPOSER:周杰伦	ALBUMNAME:神秘嘉宾
福克斯唱的江山无限	MUSIC_SEARCH	ARTIST_OR_COMPOSER:福克斯	TITLE:江山无限
离不开是谁作的词	MUSIC_SEARCH	TITLE:离不开
离不开的你是哪个歌手专属的歌么	MUSIC_SEARCH	TITLE:离不开的你
离别播放列表	MUSIC_SEARCH	GENRE:离别
秋夜被谁翻唱过	MUSIC_SEARCH	TITLE:秋夜
秋天的蓝球场属于什么人群会喜欢的歌曲	MUSIC_SEARCH	TITLE:秋天的蓝球场
秋日恋歌的曲风是什么	MUSIC_SEARCH	TITLE:秋日恋歌
秋诗篇篇的歌曲分类是什么	MUSIC_SEARCH	TITLE:秋诗篇篇
程雷最新专辑是什么	MUSIC_SEARCH	ARTIST_OR_COMPOSER:程雷
站在高岗上是最近才出的歌么	MUSIC_SEARCH	TITLE:站在高岗上
童安格新专辑	MUSIC_SEARCH	ARTIST_OR_COMPOSER:童安格
童年时这首歌好听么	MUSIC_SEARCH	TITLE:童年时
笑傲江湖这首歌怎么样	MUSIC_SEARCH	TITLE:笑傲江湖
笨却勇敢是什么专辑里的歌	MUSIC_SEARCH	TITLE:笨却勇敢
第一次是谁发行的专辑	MUSIC_SEARCH	ALBUMNAME:第一次
第一次爱的人适不适合年轻人	MUSIC_SEARCH	TITLE:第一次爱的人
第一次里都有哪些歌	MUSIC_SEARCH	ALBUMNAME:第一次
第一首歌叫啥来着	MUSIC_PLAY	ANAPHOR:第一首歌
第三首歌的歌曲名字	MUSIC_PLAY	ANAPHOR:第三首歌
第二人生是什么时候发行的	MUSIC_SEARCH	ALBUMNAME:第二人生
第二人生的歌曲是不是都是情歌	MUSIC_SEARCH	GENRE:情歌	ALBUMNAME:第二人生
第二人生这个专辑里的的歌曲类别是什么啊	MUSIC_SEARCH	ALBUMNAME:第二人生
第二人生这张专辑是几十年代出的	MUSIC_SEARCH	ALBUMNAME:第二人生
第二人生这张专辑是谁出的	MUSIC_SEARCH	ALBUMNAME:第二人生
第二人生这张专辑算不算出名	MUSIC_SEARCH	ALBUMNAME:第二人生
第二人生里的音乐歌词都是谁写的	MUSIC_SEARCH	ALBUMNAME:第二人生
第二首歌的歌名是什么	MUSIC_PLAY	ANAPHOR:第二首歌
第五季这个专辑怎么样	MUSIC_SEARCH	ALBUMNAME:第五季
等你开口把我留下来在哪个专辑里	MUSIC_SEARCH	TITLE:等你开口把我留下来
等等这个专辑里的的歌曲类别是什么啊	MUSIC_SEARCH	ALBUMNAME:等等
答案就是你是不是一个电影歌曲	MUSIC_SEARCH	GENRE:电影歌曲	TITLE:答案就是你
糊涂的爱这首歌怎么样	MUSIC_SEARCH	TITLE:糊涂的爱
红豆唱的为了你我会做到	MUSIC_SEARCH	ARTIST_OR_COMPOSER:红豆	TITLE:为了你我会做到
红酒用在哪些电影里	MUSIC_SEARCH	TITLE:红酒
约定是哪年发行的	MUSIC_SEARCH	ALBUMNAME:约定
约定这里面有什么有名的歌么	MUSIC_SEARCH	ALBUMNAME:约定
约定里面歌曲的名字都是什么	MUSIC_SEARCH	ALBUMNAME:约定
约定里面的歌曲都有什么音乐元素	MUSIC_SEARCH	ALBUMNAME:约定
纪念册这首歌是乡村音乐么	MUSIC_SEARCH	GENRE:乡村音乐	TITLE:纪念册
纯属意外这个专辑属于谁	MUSIC_SEARCH	ALBUMNAME:纯属意外
纯属意外里面有哪个年代的歌曲	MUSIC_SEARCH	ALBUMNAME:纯属意外
纯恋歌这首歌的评论怎么样	MUSIC_SEARCH	TITLE:纯恋歌
纵贯线唱过的新歌	MUSIC_SEARCH	ARTIST_OR_COMPOSER:纵贯线	GENRE:新歌
纸牌屋这个专辑是谁做的	MUSIC_SEARCH	ALBUMNAME:纸牌屋
终身伴侣这个专辑如何	MUSIC_SEARCH	ALBUMNAME:终身伴侣
经典歌曲歌组	MUSIC_SEARCH	GENRE:经典歌曲
结果咧有几个小节	MUSIC_SEARCH	TITLE:结果咧
给我找一下刘德华唱过什么歌	MUSIC_SEARCH	ARTIST_OR_COMPOSER:刘德华
给我找七十年代的老歌	MUSIC_SEARCH	year:七十年代	GENRE:老歌
给我找八十年代的歌曲	MUSIC_SEARCH	year:八十年代
给我找找励志的歌曲	MUSIC_SEARCH	GENRE:励志的歌曲
给我找找周杰伦的歌曲	MUSIC_SEARCH	ARTIST_OR_COMPOSER:周杰伦
给我找找朗朗的钢琴曲	MUSIC_SEARCH	ARTIST_OR_COMPOSER:朗朗	GENRE:钢琴曲
给我搜索七里香这个专辑	MUSIC_SEARCH	ALBUMNAME:七里香
给我搜索专辑不可不信缘	MUSIC_SEARCH	ALBUMNAME:不可不信缘
给我搜索专辑乐行者	MUSIC_SEARCH	ALBUMNAME:乐行者
给我搜索专辑再会了	MUSIC_SEARCH	ALBUMNAME:再会了
给我搜索专辑双霸	MUSIC_SEARCH	ALBUMNAME:双霸
给我搜索专辑只知道此刻爱你	MUSIC_SEARCH	ALBUMNAME:只知道此刻爱你
给我搜索专辑回到你身边	MUSIC_SEARCH	ALBUMNAME:回到你身边
给我搜索专辑如果你是我的传说	MUSIC_SEARCH	ALBUMNAME:如果你是我的传说
给我搜索专辑情感的禁区	MUSIC_SEARCH	ALBUMNAME:情感的禁区
给我搜索专辑曹操	MUSIC_SEARCH	ALBUMNAME:曹操
给我搜索专辑第二天堂	MUSIC_SEARCH	ALBUMNAME:第二天堂
给我搜索专辑西界	MUSIC_SEARCH	ALBUMNAME:西界
给我搜索专辑音乐进化全过程	MUSIC_SEARCH	ALBUMNAME:音乐进化全过程
给我搜索依然范特西这个专辑	MUSIC_SEARCH	ALBUMNAME:依然范特西
给我搜索八度空间这个专辑	MUSIC_SEARCH	ALBUMNAME:八度空间
给我搜索十一月的萧邦这个专辑	MUSIC_SEARCH	ALBUMNAME:十一月的萧邦
给我搜索叫Q版一族的专辑	MUSIC_SEARCH	ALBUMNAME:Q版一族
给我搜索叫五时三十分的专辑	MUSIC_SEARCH	ALBUMNAME:五时三十分
给我搜索叫因为爱的专辑	MUSIC_SEARCH	ALBUMNAME:因为爱
给我搜索叫天意的专辑	MUSIC_SEARCH	ALBUMNAME:天意
给我搜索叫忘情水的专辑	MUSIC_SEARCH	ALBUMNAME:忘情水
给我搜索叫情未了的专辑	MUSIC_SEARCH	ALBUMNAME:情未了
给我搜索叫来生缘的专辑	MUSIC_SEARCH	ALBUMNAME:来生缘
给我搜索叫爱在刻骨铭心时的专辑	MUSIC_SEARCH	ALBUMNAME:爱在刻骨铭心时
给我搜索叫爱的空间的专辑	MUSIC_SEARCH	ALBUMNAME:爱的空间
给我搜索叫真我的风采的专辑	MUSIC_SEARCH	ALBUMNAME:真我的风采
给我搜索叫真生命的专辑	MUSIC_SEARCH	ALBUMNAME:真生命
给我搜索叫谢谢你的爱的专辑	MUSIC_SEARCH	ALBUMNAME:谢谢你的爱
给我搜索叶惠美这个专辑	MUSIC_SEARCH	ALBUMNAME:叶惠美
给我搜索名为你可知道我爱谁的专辑	MUSIC_SEARCH	ALBUMNAME:你可知道我爱谁
给我搜索名为偿还的专辑	MUSIC_SEARCH	ALBUMNAME:偿还
给我搜索名为初次尝到寂寞的专辑	MUSIC_SEARCH	ALBUMNAME:初次尝到寂寞
给我搜索名为千言万语的专辑	MUSIC_SEARCH	ALBUMNAME:千言万语
给我搜索名为南海姑娘的专辑	MUSIC_SEARCH	ALBUMNAME:南海姑娘
给我搜索名为天国的情人的专辑	MUSIC_SEARCH	ALBUMNAME:天国的情人
给我搜索名为小城故事的专辑	MUSIC_SEARCH	ALBUMNAME:小城故事
给我搜索名为往事如昨的专辑	MUSIC_SEARCH	ALBUMNAME:往事如昨
给我搜索名为快乐的恰恰姑娘的专辑	MUSIC_SEARCH	ALBUMNAME:快乐的恰恰姑娘
给我搜索名为水上人的专辑	MUSIC_SEARCH	ALBUMNAME:水上人
给我搜索名为淡淡幽情的专辑	MUSIC_SEARCH	ALBUMNAME:淡淡幽情
给我搜索名为漫步人生路的专辑	MUSIC_SEARCH	ALBUMNAME:漫步人生路
给我搜索名为甜蜜蜜的专辑	MUSIC_SEARCH	ALBUMNAME:甜蜜蜜
给我搜索名叫一只牛的异想世界的专辑	MUSIC_SEARCH	ALBUMNAME:一只牛的异想世界
给我搜索名叫不了情的专辑	MUSIC_SEARCH	ALBUMNAME:不了情
给我搜索名叫人间爱的专辑	MUSIC_SEARCH	ALBUMNAME:人间爱
给我搜索名叫再说一次我爱你的专辑	MUSIC_SEARCH	ALBUMNAME:再说一次我爱你
给我搜索名叫别把眉儿皱的专辑	MUSIC_SEARCH	ALBUMNAME:别把眉儿皱
给我搜索名叫声音的专辑	MUSIC_SEARCH	ALBUMNAME:声音
给我搜索名叫天开了的专辑	MUSIC_SEARCH	ALBUMNAME:天开了
给我搜索名叫如果有一天的专辑	MUSIC_SEARCH	ALBUMNAME:如果有一天
给我搜索名叫妹力新世纪的专辑	MUSIC_SEARCH	ALBUMNAME:妹力新世纪
给我搜索名叫心蓝的专辑	MUSIC_SEARCH	ALBUMNAME:心蓝
给我搜索名叫爱像一首歌的专辑	MUSIC_SEARCH	ALBUMNAME:爱像一首歌
给我搜索名叫爱无知的专辑	MUSIC_SEARCH	ALBUMNAME:爱无知
给我搜索名叫美丽的一天的专辑	MUSIC_SEARCH	ALBUMNAME:美丽的一天
给我搜索名字叫丝路的专辑	MUSIC_SEARCH	ALBUMNAME:丝路
给我搜索名字叫亲亲的专辑	MUSIC_SEARCH	ALBUMNAME:亲亲
给我搜索名字叫今天情人节的专辑	MUSIC_SEARCH	ALBUMNAME:今天情人节
给我搜索名字叫完美的一天的专辑	MUSIC_SEARCH	ALBUMNAME:完美的一天
给我搜索名字叫崇拜的专辑	MUSIC_SEARCH	ALBUMNAME:崇拜
给我搜索名字叫恋爱的力量的专辑	MUSIC_SEARCH	ALBUMNAME:恋爱的力量
给我搜索名字叫我爱邓丽君的专辑	MUSIC_SEARCH	ALBUMNAME:我爱邓丽君
给我搜索名字叫我要的幸福的专辑	MUSIC_SEARCH	ALBUMNAME:我要的幸福
给我搜索名字叫未完成的专辑	MUSIC_SEARCH	ALBUMNAME:未完成
给我搜索名字叫自选辑的专辑	MUSIC_SEARCH	ALBUMNAME:自选辑
给我搜索名字叫逆光的专辑	MUSIC_SEARCH	ALBUMNAME:逆光
给我搜索名字叫风筝的专辑	MUSIC_SEARCH	ALBUMNAME:风筝
给我搜索名字是一个小心愿的专辑	MUSIC_SEARCH	ALBUMNAME:一个小心愿
给我搜索名字是一封情书的专辑	MUSIC_SEARCH	ALBUMNAME:一封情书
给我搜索名字是再见我的爱人的专辑	MUSIC_SEARCH	ALBUMNAME:再见我的爱人
给我搜索名字是原乡人的专辑	MUSIC_SEARCH	ALBUMNAME:原乡人
给我搜索名字是又见炊烟的专辑	MUSIC_SEARCH	ALBUMNAME:又见炊烟
给我搜索名字是在水一方的专辑	MUSIC_SEARCH	ALBUMNAME:在水一方
给我搜索名字是姐妹的专辑	MUSIC_SEARCH	ALBUMNAME:姐妹
给我搜索名字是小村之恋的专辑	MUSIC_SEARCH	ALBUMNAME:小村之恋
给我搜索名字是永恒巨星典藏版的专辑	MUSIC_SEARCH	ALBUMNAME:永恒巨星典藏版
给我搜索名字是牵手的专辑	MUSIC_SEARCH	ALBUMNAME:牵手
给我搜索名字是的专辑歌声妹影	MUSIC_SEARCH	ALBUMNAME:歌声妹影
给我搜索名字是艳红小曲的专辑	MUSIC_SEARCH	ALBUMNAME:艳红小曲
给我搜索唯舞独尊这个专辑	MUSIC_SEARCH	ALBUMNAME:唯舞独尊
给我搜索城堡这个专辑	MUSIC_SEARCH	ALBUMNAME:城堡
给我搜索爱的练习语这个专辑	MUSIC_SEARCH	ALBUMNAME:爱的练习语
给我搜索看我72变这个专辑	MUSIC_SEARCH	ALBUMNAME:看我72变
给我搜索舞娘这个专辑	MUSIC_SEARCH	ALBUMNAME:舞娘
给我搜索花蝴蝶这个专辑	MUSIC_SEARCH	ALBUMNAME:花蝴蝶
给我搜索范特西这个专辑	MUSIC_SEARCH	ALBUMNAME:范特西
给我搜索跨时代这个专辑	MUSIC_SEARCH	ALBUMNAME:跨时代
给我搜索魔杰座这个专辑	MUSIC_SEARCH	ALBUMNAME:魔杰座
给我查找专辑一起长大	MUSIC_SEARCH	ALBUMNAME:一起长大
给我查找专辑三天三夜	MUSIC_SEARCH	ALBUMNAME:三天三夜
给我查找专辑亲爱的理由	MUSIC_SEARCH	ALBUMNAME:亲爱的理由
给我查找专辑傻瓜探戈	MUSIC_SEARCH	ALBUMNAME:傻瓜探戈
给我查找专辑再见你好吗	MUSIC_SEARCH	ALBUMNAME:再见你好吗
给我查找专辑天蓝如海	MUSIC_SEARCH	ALBUMNAME:天蓝如海
给我查找专辑我们	MUSIC_SEARCH	ALBUMNAME:我们
给我查找专辑我知道你离我不远	MUSIC_SEARCH	ALBUMNAME:我知道你离我不远
给我查找专辑桐花	MUSIC_SEARCH	ALBUMNAME:桐花
给我查找专辑盛开	MUSIC_SEARCH	ALBUMNAME:盛开
给我查找专辑看海	MUSIC_SEARCH	ALBUMNAME:看海
给我查找专辑谢幕	MUSIC_SEARCH	ALBUMNAME:谢幕
给我查找专辑青春	MUSIC_SEARCH	ALBUMNAME:青春
给我查找专辑青春再见	MUSIC_SEARCH	ALBUMNAME:青春再见
给我查找乐之路这个专辑	MUSIC_SEARCH	ALBUMNAME:乐之路
给我查找何必再拖这个专辑	MUSIC_SEARCH	ALBUMNAME:何必再拖
给我查找叫一夜长大的专辑	MUSIC_SEARCH	ALBUMNAME:一夜长大
给我查找叫一肩之隔的专辑	MUSIC_SEARCH	ALBUMNAME:一肩之隔
给我查找叫一首心歌的专辑	MUSIC_SEARCH	ALBUMNAME:一首心歌
给我查找叫伤心的女人怎么了的专辑	MUSIC_SEARCH	ALBUMNAME:伤心的女人怎么了
给我查找叫勇气的专辑	MUSIC_SEARCH	ALBUMNAME:勇气
给我查找叫捍卫阳光的专辑	MUSIC_SEARCH	ALBUMNAME:捍卫阳光
给我查找叫漂的专辑	MUSIC_SEARCH	ALBUMNAME:漂
给我查找叫爱爱爱爱的专辑	MUSIC_SEARCH	ALBUMNAME:爱爱爱爱
给我查找叫爱过那张脸的专辑	MUSIC_SEARCH	ALBUMNAME:爱过那张脸
给我查找叫的专辑时间煮雨	MUSIC_SEARCH	ALBUMNAME:时间煮雨
给我查找叫美丽人生的专辑	MUSIC_SEARCH	ALBUMNAME:美丽人生
给我查找叫走进你的梦的专辑	MUSIC_SEARCH	ALBUMNAME:走进你的梦
给我查找叫闪亮的星的专辑	MUSIC_SEARCH	ALBUMNAME:闪亮的星
给我查找名叫三的专辑	MUSIC_SEARCH	ALBUMNAME:三
给我查找名叫世界看我的专辑	MUSIC_SEARCH	ALBUMNAME:世界看我
给我查找名叫会飞的贼的专辑	MUSIC_SEARCH	ALBUMNAME:会飞的贼
给我查找名叫光阴的故事 的专辑	MUSIC_SEARCH	ALBUMNAME:光阴的故事
给我查找名叫情话的专辑	MUSIC_SEARCH	ALBUMNAME:情话
给我查找名叫放心不下的专辑	MUSIC_SEARCH	ALBUMNAME:放心不下
给我查找名叫枪神的荣耀的专辑	MUSIC_SEARCH	ALBUMNAME:枪神的荣耀
给我查找名叫漫游的专辑	MUSIC_SEARCH	ALBUMNAME:漫游
给我查找名叫美好的专辑	MUSIC_SEARCH	ALBUMNAME:美好
给我查找名叫能不能的专辑	MUSIC_SEARCH	ALBUMNAME:能不能
给我查找名叫致青春的专辑	MUSIC_SEARCH	ALBUMNAME:致青春
给我查找名叫陪我去流浪的专辑	MUSIC_SEARCH	ALBUMNAME:陪我去流浪
给我查找名叫黄河长江的专辑	MUSIC_SEARCH	ALBUMNAME:黄河长江
给我查找名字叫下一个天亮的专辑	MUSIC_SEARCH	ALBUMNAME:下一个天亮
给我查找名字叫不想懂得的专辑	MUSIC_SEARCH	ALBUMNAME:不想懂得
给我查找名字叫华丽的冒险的专辑	MUSIC_SEARCH	ALBUMNAME:华丽的冒险
给我查找名字叫在树上唱歌的专辑	MUSIC_SEARCH	ALBUMNAME:在树上唱歌
给我查找名字叫太阳的专辑	MUSIC_SEARCH	ALBUMNAME:太阳
给我查找名字叫小宇宙的专辑	MUSIC_SEARCH	ALBUMNAME:小宇宙
给我查找名字叫我不想忘记你的专辑	MUSIC_SEARCH	ALBUMNAME:我不想忘记你
给我查找名字叫我的未来不是梦的专辑	MUSIC_SEARCH	ALBUMNAME:我的未来不是梦
给我查找名字叫无与伦比的美丽的专辑	MUSIC_SEARCH	ALBUMNAME:无与伦比的美丽
给我查找名字叫独一无二的专辑	MUSIC_SEARCH	ALBUMNAME:独一无二
给我查找名字叫苏打绿的专辑	MUSIC_SEARCH	ALBUMNAME:苏打绿
给我查找名字叫让我想一想的专辑	MUSIC_SEARCH	ALBUMNAME:让我想一想
给我查找名字叫还是会寂寞的专辑	MUSIC_SEARCH	ALBUMNAME:还是会寂寞
给我查找名字叫迟到千年的专辑	MUSIC_SEARCH	ALBUMNAME:迟到千年
给我查找天天有喜这个专辑	MUSIC_SEARCH	ALBUMNAME:天天有喜
给我查找太平盛世这个专辑	MUSIC_SEARCH	ALBUMNAME:太平盛世
给我查找太美丽这个专辑	MUSIC_SEARCH	ALBUMNAME:太美丽
给我查找好想你这个专辑	MUSIC_SEARCH	ALBUMNAME:好想你
给我查找我是海棠这个专辑	MUSIC_SEARCH	ALBUMNAME:我是海棠
给我查找我是海雅谷慕这个专辑	MUSIC_SEARCH	ALBUMNAME:我是海雅谷慕
给我查找拾伍这个专辑	MUSIC_SEARCH	ALBUMNAME:拾伍
给我查找爱的筹码这个专辑	MUSIC_SEARCH	ALBUMNAME:爱的筹码
给我查找这宅无处不在 个专辑	MUSIC_SEARCH	ALBUMNAME:宅无处不在
给我查找音乐新浪潮这个专辑	MUSIC_SEARCH	ALBUMNAME:音乐新浪潮
给我查找黑色橙子这个专辑	MUSIC_SEARCH	ALBUMNAME:黑色橙子
给我看乌兰图雅所有的歌曲	MUSIC_SEARCH	ARTIST_OR_COMPOSER:乌兰图雅
给我看这个歌的歌词	MUSIC_PLAY	ANAPHOR:这个歌
给爱人这首歌什么时候发行的	MUSIC_SEARCH	TITLE:给爱人
给男朋友是哪个歌手专属的歌么	MUSIC_SEARCH	TITLE:给男朋友
绝不呼救这个专辑是谁做的	MUSIC_SEARCH	ALBUMNAME:绝不呼救
绝症病人是哪个年代创作的	MUSIC_SEARCH	TITLE:绝症病人
绝这个歌由谁演唱过	MUSIC_SEARCH	TITLE:绝
继续堕落这首歌怎么样	MUSIC_SEARCH	TITLE:继续堕落
缘分五月是由谁演唱得	MUSIC_SEARCH	TITLE:缘分五月
网上你不该这样对我这首歌的点击量是什么	MUSIC_SEARCH	TITLE:你不该这样对我
网上再来一杯这首歌的点击量是什么	MUSIC_SEARCH	TITLE:再来一杯
网上快乐无罪这首歌的点击量是什么	MUSIC_SEARCH	TITLE:快乐无罪
网上情为难这首歌的点击量是什么	MUSIC_SEARCH	TITLE:情为难
网上找七里香这张专辑	MUSIC_SEARCH	ALBUMNAME:七里香
网上找何必再拖这张专辑	MUSIC_SEARCH	ALBUMNAME:何必再拖
网上找依照萨克斯曲	MUSIC_SEARCH	GENRE:萨克斯曲
网上找十一月的肖邦这张专辑	MUSIC_SEARCH	ALBUMNAME:十一月的肖邦
网上找幸福了然后呢这张专辑	MUSIC_SEARCH	ALBUMNAME:幸福了然后呢
网上找找日语歌曲	MUSIC_SEARCH	GENRE:日语歌曲
网上找找英语歌曲	MUSIC_SEARCH	GENRE:英语歌曲
网上找欧美经典歌曲	MUSIC_SEARCH	GENRE:欧美经典歌曲
网上搜索丁当唱过的歌	MUSIC_SEARCH	ARTIST_OR_COMPOSER:丁当
网上搜索七里香这张专辑	MUSIC_SEARCH	ALBUMNAME:七里香
网上搜索乡村歌曲	MUSIC_SEARCH	GENRE:乡村歌曲
网上搜索动漫歌曲	MUSIC_SEARCH	GENRE:动漫歌曲
网上搜索印度歌曲	MUSIC_SEARCH	GENRE:印度歌曲
网上搜索四个朋友这张专辑	MUSIC_SEARCH	ALBUMNAME:四个朋友
网上搜索所有的二胡曲	MUSIC_SEARCH	GENRE:二胡曲
网上搜索超有感这张专辑	MUSIC_SEARCH	ALBUMNAME:超有感
网上搜索麦田捕手这张专辑	MUSIC_SEARCH	ALBUMNAME:麦田捕手
网上有什么儿歌	MUSIC_SEARCH	GENRE:儿歌
网上查找刘若英的歌曲	MUSIC_SEARCH	ARTIST_OR_COMPOSER:刘若英
网上能不能找找伤逝这支歌	MUSIC_SEARCH	TITLE:伤逝
网上能不能找找情瘤感菌这支歌	MUSIC_SEARCH	TITLE:情瘤感菌
网上能不能找找绵绵旧情这支歌	MUSIC_SEARCH	TITLE:绵绵旧情
网上能不能找找薄情书这支歌	MUSIC_SEARCH	TITLE:薄情书
网海之恋这个专辑怎么样	MUSIC_SEARCH	ALBUMNAME:网海之恋
网络情缘的作词家是什么	MUSIC_SEARCH	TITLE:网络情缘
罗丹的无糖风格	MUSIC_SEARCH	ARTIST_OR_COMPOSER:罗丹	TITLE:无糖风格
罗大佑喜欢唱什么类型的歌	MUSIC_SEARCH	ARTIST_OR_COMPOSER:罗大佑
罗大佑播放列表	MUSIC_SEARCH	ARTIST_OR_COMPOSER:罗大佑
罗大佑有几个专辑	MUSIC_SEARCH	ARTIST_OR_COMPOSER:罗大佑
美丽坏女人算不算是比较非主流的音乐	MUSIC_SEARCH	GENRE:非主流	TITLE:美丽坏女人
美国有哪几个比较有名的歌手	MUSIC_SEARCH	GENRE:美国
美好什么时候发行	MUSIC_SEARCH	ALBUMNAME:美好
美好这张专辑是什么时候出的	MUSIC_SEARCH	ALBUMNAME:美好
美好里的音乐歌词都是谁写的	MUSIC_SEARCH	ALBUMNAME:美好
耍大牌的歌词都说的什么	MUSIC_SEARCH	TITLE:耍大牌
聪明的笨男人这首曲子被下载过多少次	MUSIC_SEARCH	TITLE:聪明的笨男人
肖淑平歌组	MUSIC_SEARCH	ARTIST_OR_COMPOSER:肖淑平
肯尼罗杰斯新专辑	MUSIC_SEARCH	ARTIST_OR_COMPOSER:肯尼罗杰斯
能不能下载宅无处不在这张专辑	MUSIC_SEARCH	ALBUMNAME:宅无处不在
能不能下载爱的进行式这张专辑	MUSIC_SEARCH	ALBUMNAME:爱的进行式
能不能下载跨出界这张专辑	MUSIC_SEARCH	ALBUMNAME:跨出界
能不能下载青春无敌这张专辑	MUSIC_SEARCH	ALBUMNAME:青春无敌
能不能在网上找硬摇滚	MUSIC_SEARCH	GENRE:硬摇滚
能不能找到二胡曲	MUSIC_SEARCH	GENRE:二胡曲
能不能找到小提琴曲	MUSIC_SEARCH	GENRE:小提琴曲
能不能找找拉丁歌曲	MUSIC_SEARCH	GENRE:拉丁歌曲
能不能是几几年发行的	MUSIC_SEARCH	ALBUMNAME:能不能
自己照顾自己这首歌在它的专辑里是第几个	MUSIC_SEARCH	TITLE:自己照顾自己
自由自在是不是在世界各地都流行的歌曲	MUSIC_SEARCH	TITLE:自由自在
至少还有你爱很简单有哪几个歌手演唱过	MUSIC_SEARCH	TITLE:至少还有你爱很简单
致纯静属于什么类型的音乐	MUSIC_SEARCH	ALBUMNAME:致纯静
致纯静这张专辑算不算出名	MUSIC_SEARCH	ALBUMNAME:致纯静
致纯静里面的歌曲都有什么音乐元素	MUSIC_SEARCH	ALBUMNAME:致纯静
致青春这个专辑如何	MUSIC_SEARCH	ALBUMNAME:致青春
舞动全世界这里面有什么有名的歌么	MUSIC_SEARCH	ALBUMNAME:舞动全世界
舞动全世界里面的歌曲都是哪几个歌手唱的	MUSIC_SEARCH	ALBUMNAME:舞动全世界
船是不是周杰伦唱过的	MUSIC_SEARCH	ARTIST_OR_COMPOSER:周杰伦	TITLE:船
船歌这首歌有多长	MUSIC_SEARCH	TITLE:船歌
芭比电话有很多人听么	MUSIC_SEARCH	TITLE:芭比电话
花儿开了现在是不是很流行	MUSIC_SEARCH	TITLE:花儿开了
花如雪是一首情歌么	MUSIC_SEARCH	GENRE:情歌	TITLE:花如雪
花开花落这首歌怎么样	MUSIC_SEARCH	TITLE:花开花落
花样年华在哪天发行	MUSIC_SEARCH	ALBUMNAME:花样年华
花样年华属于哪种类型的音乐	MUSIC_SEARCH	ALBUMNAME:花样年华
花瓣雨是不是个流行音乐	MUSIC_SEARCH	GENRE:流行音乐	TITLE:花瓣雨
花的话这首歌在它的专辑里是第几个	MUSIC_SEARCH	TITLE:花的话
花花女孩这个专辑是谁做的	MUSIC_SEARCH	ALBUMNAME:花花女孩
花落随这首歌是什么时候出的	MUSIC_SEARCH	TITLE:花落随
花蝴蝶算不算是八十年代的歌曲	MUSIC_SEARCH	year:八十年代	TITLE:花蝴蝶
苍穷适不适合老年人听	MUSIC_SEARCH	TITLE:苍穷
苏打绿的歌都有什么	MUSIC_SEARCH	ARTIST_OR_COMPOSER:苏打绿
苏格兰音乐都好听么	MUSIC_SEARCH	GENRE:苏格兰音乐
英语歌歌组	MUSIC_SEARCH	GENRE:英语歌
英雄路的歌词都告诉我	MUSIC_SEARCH	TITLE:英雄路
范玮琪唱过哪几首歌曲	MUSIC_SEARCH	ARTIST_OR_COMPOSER:范玮琪
莲儿与啷当六便士合唱团唱的候鸟	MUSIC_SEARCH	ARTIST_OR_COMPOSER:莲儿与啷当六便士合唱团	TITLE:候鸟
菲感情生活这个专辑如何	MUSIC_SEARCH	ALBUMNAME:菲感情生活
萌芽的作曲灵感来源于什么	MUSIC_SEARCH	TITLE:萌芽
萧敬腾都唱过哪些歌	MUSIC_SEARCH	ARTIST_OR_COMPOSER:萧敬腾
萱宁新专辑	MUSIC_SEARCH	ARTIST_OR_COMPOSER:萱宁
落单的候鸟有没有被翻译到英文过	MUSIC_SEARCH	TITLE:落单的候鸟
落脚的作曲是谁	MUSIC_SEARCH	TITLE:落脚
葫芦曲歌组	MUSIC_SEARCH	GENRE:葫芦曲
蒙古人这首歌是谁唱的	MUSIC_SEARCH	TITLE:蒙古人
蒲公英的约定这首歌好么	MUSIC_SEARCH	TITLE:蒲公英的约定
蒲界耶稣的歌词是什么	MUSIC_SEARCH	TITLE:蒲界耶稣
蓝色妖姬属于什么音乐	MUSIC_SEARCH	TITLE:蓝色妖姬
蓝色生死恋的演唱家是谁	MUSIC_SEARCH	TITLE:蓝色生死恋
蓝雨最新专辑是什么	MUSIC_SEARCH	ARTIST_OR_COMPOSER:蓝雨
蔡枫华唱的有没有那么一首歌	MUSIC_SEARCH	ARTIST_OR_COMPOSER:蔡枫华	TITLE:有没有那么一首歌
蕾哈娜唱过女朋友吗	MUSIC_SEARCH	ARTIST_OR_COMPOSER:蕾哈娜	TITLE:女朋友
虎牙的歌词	MUSIC_SEARCH	TITLE:虎牙
蚊子爱情进行曲有哪几个歌手演唱过	MUSIC_SEARCH	TITLE:蚊子爱情进行曲
蜜月相册的作曲家是谁	MUSIC_SEARCH	TITLE:蜜月相册
蝴蝶飞了的作曲家是谁	MUSIC_SEARCH	TITLE:蝴蝶飞了
街头霸王新专辑	MUSIC_SEARCH	ARTIST_OR_COMPOSER:街头霸王
街头霸王的爱的筹码	MUSIC_SEARCH	ARTIST_OR_COMPOSER:街头霸王	ALBUMNAME:爱的筹码
表白这个专辑怎么样	MUSIC_SEARCH	ALBUMNAME:表白
西海情歌的原唱是谁	MUSIC_SEARCH	TITLE:西海情歌
西班牙国歌这首歌来自哪个国家	MUSIC_SEARCH	TITLE:西班牙国歌
西班牙语歌曲播放列表	MUSIC_SEARCH	GENRE:西班牙语歌曲
西班牙语的歌曲显示出来	MUSIC_SEARCH	GENRE:西班牙语的歌曲
西门吹雪是不是个流行音乐	MUSIC_SEARCH	GENRE:流行音乐	TITLE:西门吹雪
见你好吗发行当天的销量如何	MUSIC_SEARCH	ALBUMNAME:见你好吗
认床的歌词都告诉我	MUSIC_SEARCH	TITLE:认床
让我听你这首歌在它的专辑里是第几个	MUSIC_SEARCH	TITLE:让我听你
让我悄悄离去的作词家是谁	MUSIC_SEARCH	TITLE:让我悄悄离去
让我让你崩溃这首歌来自哪个国家	MUSIC_SEARCH	TITLE:让我让你崩溃
让暴风雨来得更猛烈些吧这首曲子被下载过多少次	MUSIC_SEARCH	TITLE:让暴风雨来得更猛烈些吧
让爱继续这首歌是谁唱的	MUSIC_SEARCH	TITLE:让爱继续
讲不出再见的作曲家叫什么名字	MUSIC_SEARCH	TITLE:讲不出再见
话说从头这首歌什么时候发行的	MUSIC_SEARCH	TITLE:话说从头
说唱音乐播放列表	MUSIC_SEARCH	GENRE:说唱音乐
诺拉琼斯唱了翻身的日子吗	MUSIC_SEARCH	ARTIST_OR_COMPOSER:诺拉琼斯	TITLE:翻身的日子
谁不服单挑是什么乐团的	MUSIC_SEARCH	TITLE:谁不服单挑
谁人知属于什么歌	MUSIC_SEARCH	TITLE:谁人知
谁令你心痴是什么乐团的	MUSIC_SEARCH	TITLE:谁令你心痴
谁写的仨人	MUSIC_SEARCH	TITLE:仨人
谁写的再见了最爱的人	MUSIC_SEARCH	TITLE:再见了最爱的人
谁写的选择牺牲	MUSIC_SEARCH	TITLE:选择牺牲
谁写的韩流来袭	MUSIC_SEARCH	TITLE:韩流来袭
谁出的专辑再见你好吗	MUSIC_SEARCH	ALBUMNAME:再见你好吗
谁出的专辑可爱的宝贝	MUSIC_SEARCH	ALBUMNAME:可爱的宝贝
谁出的专辑排行这张专辑	MUSIC_SEARCH	ALBUMNAME:专辑排行
谁出的专辑永远的永远	MUSIC_SEARCH	ALBUMNAME:永远的永远
谁出的专辑错过	MUSIC_SEARCH	ALBUMNAME:错过
谁出的我是海棠这张专辑	MUSIC_SEARCH	ALBUMNAME:我是海棠
谁出的海阔天空这张专辑	MUSIC_SEARCH	ALBUMNAME:海阔天空
谁出的魔杰座这张专辑	MUSIC_SEARCH	ALBUMNAME:魔杰座
谁发行的关不掉的月光这个专辑	MUSIC_SEARCH	ALBUMNAME:关不掉的月光
谁发行的十二新作这个专辑	MUSIC_SEARCH	ALBUMNAME:十二新作
谁发行的见你好吗这个专辑	MUSIC_SEARCH	ALBUMNAME:见你好吗
谁发行的跨出界这个专辑	MUSIC_SEARCH	ALBUMNAME:跨出界
谁唱的哑巴新娘这首歌	MUSIC_SEARCH	TITLE:哑巴新娘
谁唱的哭泣的拳头	MUSIC_SEARCH	TITLE:哭泣的拳头
谁唱的啦啦队歌这首歌	MUSIC_SEARCH	TITLE:啦啦队歌
谁唱的在爱的路上走呀走这首歌	MUSIC_SEARCH	TITLE:在爱的路上走呀走
谁唱的我的歌声里这首歌	MUSIC_SEARCH	TITLE:我的歌声里
谁唱的时光雨这首歌	MUSIC_SEARCH	TITLE:时光雨
谁唱的暗恋航空	MUSIC_SEARCH	TITLE:暗恋航空
谁唱的有谁能够爱你超过我	MUSIC_SEARCH	TITLE:有谁能够爱你超过我
谁唱的玩乐	MUSIC_SEARCH	TITLE:玩乐
谁唱的用一千双手臂拥抱你这首歌	MUSIC_SEARCH	TITLE:用一千双手臂拥抱你
谁唱的看袂落去	MUSIC_SEARCH	TITLE:看袂落去
谁唱的第二世这首歌	MUSIC_SEARCH	TITLE:第二世
谁唱的绝情歌	MUSIC_SEARCH	TITLE:绝情歌
谁唱的蒲公英在飞这首歌	MUSIC_SEARCH	TITLE:蒲公英在飞
谁唱的还以为	MUSIC_SEARCH	TITLE:还以为
谁唱的锡林河边的老人这首歌	MUSIC_SEARCH	TITLE:锡林河边的老人
谁唱的麻辣公主	MUSIC_SEARCH	TITLE:麻辣公主
谁录制的右手边这张专辑	MUSIC_SEARCH	ALBUMNAME:右手边
谁录制的叶惠美这张专辑	MUSIC_SEARCH	ALBUMNAME:叶惠美
谁录制的天使之翼这张专辑	MUSIC_SEARCH	ALBUMNAME:天使之翼
谁录制的女人心事这张专辑	MUSIC_SEARCH	ALBUMNAME:女人心事
谁演唱的12新作这张专辑	MUSIC_SEARCH	ALBUMNAME:12新作
谁演唱的一首心歌这张专辑	MUSIC_SEARCH	ALBUMNAME:一首心歌
谁演唱的以爱之名这张专辑	MUSIC_SEARCH	ALBUMNAME:以爱之名
谁演唱的错过这张专辑	MUSIC_SEARCH	ALBUMNAME:错过
谁演唱过壁虎漫步这首歌	MUSIC_SEARCH	TITLE:壁虎漫步
谁演唱过秘密这首歌	MUSIC_SEARCH	TITLE:秘密
谁演唱过那就这样吧这首歌	MUSIC_SEARCH	TITLE:那就这样吧
谁演唱过雨声街这首歌	MUSIC_SEARCH	TITLE:雨声街
谁给夏夕夏景作的词	MUSIC_SEARCH	TITLE:夏夕夏景
谁给好梦太匆匆作的词	MUSIC_SEARCH	TITLE:好梦太匆匆
谁给我了解你作的词	MUSIC_SEARCH	TITLE:我了解你
谁给爱的魔法作的词	MUSIC_SEARCH	TITLE:爱的魔法
谁翻唱过塔罗牌恋人	MUSIC_SEARCH	TITLE:塔罗牌恋人
谁翻唱过爱上我的朋友	MUSIC_SEARCH	TITLE:爱上我的朋友
谁翻唱过爱你不是浑闲事	MUSIC_SEARCH	TITLE:爱你不是浑闲事
谁翻唱过蒨意	MUSIC_SEARCH	TITLE:蒨意
谁负责给昨迟人这首歌作词	MUSIC_SEARCH	TITLE:昨迟人
谁负责给有一天这首歌作词	MUSIC_SEARCH	TITLE:有一天
谁负责给桃花源这首歌作词	MUSIC_SEARCH	TITLE:桃花源
谁负责给除非你这首歌作词	MUSIC_SEARCH	TITLE:除非你
调情这首歌属于什么曲风	MUSIC_SEARCH	TITLE:调情
谍对谍被谁翻唱过	MUSIC_SEARCH	TITLE:谍对谍
谜这首歌怎么样啊	MUSIC_SEARCH	TITLE:谜
谢军歌组	MUSIC_SEARCH	ARTIST_OR_COMPOSER:谢军
谢孟伟的那首公主的迷信	MUSIC_SEARCH	ARTIST_OR_COMPOSER:谢孟伟	TITLE:公主的迷信
谢幕里面的歌有名么	MUSIC_SEARCH	ALBUMNAME:谢幕
谭扬新专辑	MUSIC_SEARCH	ARTIST_OR_COMPOSER:谭扬
谭某某被谁演唱过	MUSIC_SEARCH	TITLE:谭某某
贝多芬的悲伤的歌词都告诉我	MUSIC_SEARCH	TITLE:贝多芬的悲伤
贝蒂米勒唱过的爱情男女	MUSIC_SEARCH	ARTIST_OR_COMPOSER:贝蒂米勒	TITLE:爱情男女
财神到的作曲家是谁	MUSIC_SEARCH	TITLE:财神到
贯家郡唱过的纯粹	MUSIC_SEARCH	ARTIST_OR_COMPOSER:贯家郡	GENRE:纯粹
贱女人坏男人是作做的词	MUSIC_SEARCH	TITLE:贱女人坏男人
赛门唱过的经典歌曲	MUSIC_SEARCH	ARTIST_OR_COMPOSER:赛门	GENRE:经典歌曲
赤地雪这首歌是从哪儿来的	MUSIC_SEARCH	TITLE:赤地雪
走火枪是最近才出的歌么	MUSIC_SEARCH	TITLE:走火枪
赵PD的专辑列表	MUSIC_SEARCH	ARTIST_OR_COMPOSER:赵PD
赵英其专辑的信息	MUSIC_SEARCH	ARTIST_OR_COMPOSER:赵英其
超人属于什么歌	MUSIC_SEARCH	TITLE:超人
超有感这张专辑算不算出名	MUSIC_SEARCH	ALBUMNAME:超有感
跟我说一下好想好好爱你的信息	MUSIC_SEARCH	TITLE:好想好好爱你
跟我说一下念念不忘的信息	MUSIC_SEARCH	TITLE:念念不忘
跟我说一下沙漠之足的信息	MUSIC_SEARCH	TITLE:沙漠之足
跟我说一下爱过的你还在我心里的信息	MUSIC_SEARCH	TITLE:爱过的你还在我心里
跟我说说周杰伦怎么样	MUSIC_SEARCH	ARTIST_OR_COMPOSER:周杰伦
跨出界是什么时候发行的	MUSIC_SEARCH	ALBUMNAME:跨出界
跨出界这张专辑是谁出的	MUSIC_SEARCH	ALBUMNAME:跨出界
跨出界里的歌都算不算流行音乐啊	MUSIC_SEARCH	GENRE:流行音乐	ALBUMNAME:跨出界
跨时代去年的发行量是多少	MUSIC_SEARCH	year:去年	ALBUMNAME:跨时代
跨时代这张专辑最近很火么	MUSIC_SEARCH	ALBUMNAME:跨时代
路太远这个歌由谁演唱过	MUSIC_SEARCH	TITLE:路太远
路童唱过的原谅我一次	MUSIC_SEARCH	ARTIST_OR_COMPOSER:路童	TITLE:原谅我一次
跳房子的那首伙伴	MUSIC_SEARCH	ARTIST_OR_COMPOSER:跳房子	TITLE:伙伴
踏古来自于哪个专辑	MUSIC_SEARCH	TITLE:踏古
踏歌而行的什么地区的歌	MUSIC_SEARCH	TITLE:踏歌而行
轻闭双眼是什么类型的歌	MUSIC_SEARCH	TITLE:轻闭双眼
输情歌是什么类型的歌	MUSIC_SEARCH	TITLE:输情歌
辛晓琪的歌是不是都好听	MUSIC_SEARCH	ARTIST_OR_COMPOSER:辛晓琪
辰伶的小眼睛的姑娘	MUSIC_SEARCH	ARTIST_OR_COMPOSER:辰伶	TITLE:小眼睛的姑娘
过把瘾这首歌怎么样	MUSIC_SEARCH	TITLE:过把瘾
过期情雪的歌词是什么	MUSIC_SEARCH	TITLE:过期情雪
迈克尔勃顿唱过的怀旧的音乐	MUSIC_SEARCH	ARTIST_OR_COMPOSER:迈克尔勃顿	GENRE:怀旧的音乐
迈克尔杰克逊唱过什么歌	MUSIC_SEARCH	ARTIST_OR_COMPOSER:迈克尔杰克逊
迈克尔杰克逊尝过的歌	MUSIC_SEARCH	ARTIST_OR_COMPOSER:迈克尔杰克逊
这一拜这首歌怎么样	MUSIC_SEARCH	TITLE:这一拜
这一首歌是哪首	MUSIC_PLAY	ANAPHOR:这一首歌
这个因为我爱你专辑是谁做的	MUSIC_SEARCH	ALBUMNAME:因为我爱你
这么近那么远的歌曲分类是什么	MUSIC_SEARCH	TITLE:这么近那么远
这就是爱吗这首歌是什么分类	MUSIC_SEARCH	TITLE:这就是爱吗
这歌是什么名字	MUSIC_PLAY	ANAPHOR:这歌
这首歌叫什么	MUSIC_PLAY	ANAPHOR:这首歌
远在天边这首歌是乡村音乐么	MUSIC_SEARCH	GENRE:乡村音乐	TITLE:远在天边
远方的那首请你保重	MUSIC_SEARCH	ARTIST_OR_COMPOSER:远方	TITLE:请你保重
远远在一起这首歌谁演唱过	MUSIC_SEARCH	TITLE:远远在一起
违章动物这个专辑是谁做的	MUSIC_SEARCH	ALBUMNAME:违章动物
连释的那首你知道我才知道	MUSIC_SEARCH	ARTIST_OR_COMPOSER:连释	TITLE:你知道我才知道
迟到属于几十年代的歌曲	MUSIC_SEARCH	TITLE:迟到
迟来的春天这首歌有没有吸收拉丁美洲的元素	MUSIC_SEARCH	TITLE:迟来的春天
迷你电影是不是在六十年代很流行	MUSIC_SEARCH	TITLE:迷你电影	year:六十年代
迷失表参道这首歌怎么样啊	MUSIC_SEARCH	TITLE:迷失表参道
追究都有什么语言的版本	MUSIC_SEARCH	TITLE:追究
送你一程被谁翻唱过	MUSIC_SEARCH	TITLE:送你一程
送行是什么时候的歌	MUSIC_SEARCH	TITLE:送行
通往天堂的阶梯这个歌是谁唱的	MUSIC_SEARCH	TITLE:通往天堂的阶梯
逼得太紧是哪个国家的歌曲	MUSIC_SEARCH	TITLE:逼得太紧
邓丽君有四个朋友这个专辑么	MUSIC_SEARCH	ARTIST_OR_COMPOSER:邓丽君	ALBUMNAME:四个朋友
邓丽君有桐花这个专辑么	MUSIC_SEARCH	ARTIST_OR_COMPOSER:邓丽君	ALBUMNAME:桐花
邓丽君有爱的进行式这个专辑么	MUSIC_SEARCH	ARTIST_OR_COMPOSER:邓丽君	ALBUMNAME:爱的进行式
邓丽君有看海这个专辑么	MUSIC_SEARCH	ARTIST_OR_COMPOSER:邓丽君	ALBUMNAME:看海
邓建明播放列表	MUSIC_SEARCH	ARTIST_OR_COMPOSER:邓建明
邓鼓的歌怎么样啊	MUSIC_SEARCH	ARTIST_OR_COMPOSER:邓鼓
那英有几个专辑	MUSIC_SEARCH	ARTIST_OR_COMPOSER:那英
那英这些年唱过哪几首歌	MUSIC_SEARCH	ARTIST_OR_COMPOSER:那英
邱家烈唱过的摇滚歌曲	MUSIC_SEARCH	ARTIST_OR_COMPOSER:邱家烈	GENRE:摇滚歌曲
邱颖欣的我知道你离我不远	MUSIC_SEARCH	ARTIST_OR_COMPOSER:邱颖欣	ALBUMNAME:我知道你离我不远
郁可唯的歌曲都怎么样	MUSIC_SEARCH	ARTIST_OR_COMPOSER:郁可唯
郑元畅新专辑	MUSIC_SEARCH	ARTIST_OR_COMPOSER:郑元畅
郑华娟新专辑	MUSIC_SEARCH	ARTIST_OR_COMPOSER:郑华娟
郑华娟最新专辑是什么	MUSIC_SEARCH	ARTIST_OR_COMPOSER:郑华娟
郑华娟的专辑列表	MUSIC_SEARCH	ARTIST_OR_COMPOSER:郑华娟
郑建鹏最新专辑是什么	MUSIC_SEARCH	ARTIST_OR_COMPOSER:郑建鹏
郑源唱过几首歌	MUSIC_SEARCH	ARTIST_OR_COMPOSER:郑源
郑琇月新专辑	MUSIC_SEARCH	ARTIST_OR_COMPOSER:郑琇月
郭书瑶唱的相亲相爱一家人	MUSIC_SEARCH	ARTIST_OR_COMPOSER:郭书瑶	TITLE:相亲相爱一家人
郭力行最新专辑是什么	MUSIC_SEARCH	ARTIST_OR_COMPOSER:郭力行
酷啦啦的词是哪首宋词	MUSIC_SEARCH	TITLE:酷啦啦
酷爱被谁翻唱过	MUSIC_SEARCH	TITLE:酷爱
醇经典这个专辑如何	MUSIC_SEARCH	ALBUMNAME:醇经典
重复犯错算不算是八十年代的歌曲	MUSIC_SEARCH	year:八十年代	TITLE:重复犯错
重见家圆的歌词是什么	MUSIC_SEARCH	TITLE:重见家圆
野丫头属于什么类型的歌曲	MUSIC_SEARCH	TITLE:野丫头
野孩子唱过的父亲节	MUSIC_SEARCH	ARTIST_OR_COMPOSER:野孩子	GENRE:父亲节
金·布里克的擦干你的泪水	MUSIC_SEARCH	ARTIST_OR_COMPOSER:金·布里克	TITLE:擦干你的泪水
金银岛有没有被翻译到英文过	MUSIC_SEARCH	TITLE:金银岛
钟汉良唱的反方向的钟	MUSIC_SEARCH	ARTIST_OR_COMPOSER:钟汉良	TITLE:反方向的钟
钟洁希唱了残缺的歌吗	MUSIC_SEARCH	ARTIST_OR_COMPOSER:钟洁希	TITLE:残缺的歌
锉冰进行曲属于什么类型的歌曲	MUSIC_SEARCH	TITLE:锉冰进行曲
错不在你都有什么语言的版本	MUSIC_SEARCH	TITLE:错不在你
错过是什么时候发行的	MUSIC_SEARCH	ALBUMNAME:错过
错过这个专辑出自哪个年代	MUSIC_SEARCH	ALBUMNAME:错过
长渕刚的专辑列表	MUSIC_SEARCH	ARTIST_OR_COMPOSER:长渕刚
闪亮三姐妹的你在叨位	MUSIC_SEARCH	ARTIST_OR_COMPOSER:闪亮三姐妹	TITLE:你在叨位
闪亮亮的作词家叫什么名字	MUSIC_SEARCH	TITLE:闪亮亮
闪光魔术这首歌的主题是什么	MUSIC_SEARCH	TITLE:闪光魔术
阅读过去是什么年代的歌曲	MUSIC_SEARCH	TITLE:阅读过去
阎韦伶的倾斜	MUSIC_SEARCH	ARTIST_OR_COMPOSER:阎韦伶	TITLE:倾斜
阳光和煦是什么专辑里的歌	MUSIC_SEARCH	TITLE:阳光和煦
阿兰的歌好不好听	MUSIC_SEARCH	ARTIST_OR_COMPOSER:阿兰
阿嬷的话多长	MUSIC_SEARCH	TITLE:阿嬷的话
阿根廷别为我哭泣这首歌在什么专辑	MUSIC_SEARCH	TITLE:阿根廷别为我哭泣
阿菲正传这个专辑如何	MUSIC_SEARCH	ALBUMNAME:阿菲正传
陈信宏唱过的钗头凤	MUSIC_SEARCH	ARTIST_OR_COMPOSER:陈信宏	TITLE:钗头凤
陈升唱过什么歌	MUSIC_SEARCH	ARTIST_OR_COMPOSER:陈升
陈嘉桦唱的泡泡世界	MUSIC_SEARCH	ARTIST_OR_COMPOSER:陈嘉桦	TITLE:泡泡世界
陈奕专辑的信息	MUSIC_SEARCH	ARTIST_OR_COMPOSER:陈奕
陈奕迅都演唱过什么歌	MUSIC_SEARCH	ARTIST_OR_COMPOSER:陈奕迅
陈宝珠歌组	MUSIC_SEARCH	ARTIST_OR_COMPOSER:陈宝珠
陈庆祥播放列表	MUSIC_SEARCH	ARTIST_OR_COMPOSER:陈庆祥
陈明真唱过想你零点零一分吗	MUSIC_SEARCH	ARTIST_OR_COMPOSER:陈明真	TITLE:想你零点零一分
陈楚生的那首东北人不是黑社会	MUSIC_SEARCH	ARTIST_OR_COMPOSER:陈楚生	TITLE:东北人不是黑社会
陈浩峰唱的难忘今宵	MUSIC_SEARCH	ARTIST_OR_COMPOSER:陈浩峰	TITLE:难忘今宵
陈瑀涵的那首明日晴れるかな	MUSIC_SEARCH	ARTIST_OR_COMPOSER:陈瑀涵	TITLE:明日晴れるかな
陈瑞的歌声好听么	MUSIC_SEARCH	ARTIST_OR_COMPOSER:陈瑞
陈百强最新专辑是什么	MUSIC_SEARCH	ARTIST_OR_COMPOSER:陈百强
陈秀环专辑的信息	MUSIC_SEARCH	ARTIST_OR_COMPOSER:陈秀环
陪我去流浪的歌曲风格是什么	MUSIC_SEARCH	ALBUMNAME:陪我去流浪
陪我去流浪里的歌曲主要是谁写的曲	MUSIC_SEARCH	ALBUMNAME:陪我去流浪
陪我去流浪里面有什么中文歌曲	MUSIC_SEARCH	GENRE:中文歌曲	ALBUMNAME:陪我去流浪
陪我去流浪里面都是那个年代的歌	MUSIC_SEARCH	ALBUMNAME:陪我去流浪
陶莉萍播放列表	MUSIC_SEARCH	ARTIST_OR_COMPOSER:陶莉萍
隐形情人适不适合年轻人	MUSIC_SEARCH	TITLE:隐形情人
隔世离空的红颜这首歌的音乐好听么	MUSIC_SEARCH	TITLE:隔世离空的红颜
难以抗拒你容颜是什么类型的歌曲啊	MUSIC_SEARCH	TITLE:难以抗拒你容颜
难得是今晚是不是在世界各地都流行的歌曲	MUSIC_SEARCH	TITLE:难得是今晚
雌雄同体的最曲家是谁	MUSIC_SEARCH	TITLE:雌雄同体
雨中背影的歌名啥意思	MUSIC_SEARCH	TITLE:雨中背影
雨中飘荡的回忆这首歌几分钟长	MUSIC_SEARCH	TITLE:雨中飘荡的回忆
雨季不停的作曲家是谁	MUSIC_SEARCH	TITLE:雨季不停
雨街这首歌是谁唱的	MUSIC_SEARCH	TITLE:雨街
雷安娜最新专辑是什么	MUSIC_SEARCH	ARTIST_OR_COMPOSER:雷安娜
雷龙专辑的信息	MUSIC_SEARCH	ARTIST_OR_COMPOSER:雷龙
霍元甲这个专辑是谁唱的	MUSIC_SEARCH	ALBUMNAME:霍元甲
青春什么时候发行	MUSIC_SEARCH	ALBUMNAME:青春
青春卖多少钱	MUSIC_SEARCH	ALBUMNAME:青春
青春无敌这个专辑里的的歌曲类别是什么啊	MUSIC_SEARCH	ALBUMNAME:青春无敌
青春无敌里的歌曲主要是谁写的曲	MUSIC_SEARCH	ALBUMNAME:青春无敌
青春这张专辑由哪个公司发行的	MUSIC_SEARCH	ALBUMNAME:青春
青春里面有什么英文歌曲	MUSIC_SEARCH	GENRE:英文歌曲	ALBUMNAME:青春
青春里面的歌有名么	MUSIC_SEARCH	ALBUMNAME:青春
青花瓷这首歌怎么样	MUSIC_SEARCH	TITLE:青花瓷
静夜的单簧管的词是哪首古诗	MUSIC_SEARCH	TITLE:静夜的单簧管
非教育是哪个电影里的歌曲么	MUSIC_SEARCH	TITLE:非教育
革命歌曲播放列表	MUSIC_SEARCH	GENRE:革命歌曲
韩信新专辑	MUSIC_SEARCH	ARTIST_OR_COMPOSER:韩信
韩再芬唱过的迫在眉梢	MUSIC_SEARCH	ARTIST_OR_COMPOSER:韩再芬	TITLE:迫在眉梢
韩文歌曲播放列表	MUSIC_SEARCH	GENRE:韩文歌曲
项央卓玛唱过的歌曲	MUSIC_SEARCH	ARTIST_OR_COMPOSER:项央卓玛
颓废播放列表	MUSIC_SEARCH	GENRE:颓废
颓废的音乐歌组	MUSIC_SEARCH	GENRE:颓废的音乐
风声边界是不是一个电影歌曲	MUSIC_SEARCH	GENRE:电影歌曲	TITLE:风声边界
飘鸟在哪个专辑里	MUSIC_SEARCH	TITLE:飘鸟
飞儿乐团是几几年发行的	MUSIC_SEARCH	ALBUMNAME:飞儿乐团
马睿菈最新专辑是什么	MUSIC_SEARCH	ARTIST_OR_COMPOSER:马睿菈
骄傲算不算是八十年代的歌曲	MUSIC_SEARCH	year:八十年代	TITLE:骄傲
高山青这首歌是什么时候出的	MUSIC_SEARCH	TITLE:高山青
高慧君的幸福选择题	MUSIC_SEARCH	ARTIST_OR_COMPOSER:高慧君	ALBUMNAME:幸福选择题
高登的11月的肖邦	MUSIC_SEARCH	ARTIST_OR_COMPOSER:高登	ALBUMNAME:11月的肖邦
魔杰座这里面有什么有名的歌么	MUSIC_SEARCH	ALBUMNAME:魔杰座
鲜花插在牛粪上这首歌怎么样	MUSIC_SEARCH	TITLE:鲜花插在牛粪上
鳄鱼泪这首歌几分钟长	MUSIC_SEARCH	TITLE:鳄鱼泪
麦浚龙新专辑	MUSIC_SEARCH	ARTIST_OR_COMPOSER:麦浚龙
麦田捕手什么时候发行	MUSIC_SEARCH	ALBUMNAME:麦田捕手
麦田捕手属于哪种类型的音乐	MUSIC_SEARCH	ALBUMNAME:麦田捕手
麦田捕手是什么时候发行的	MUSIC_SEARCH	ALBUMNAME:麦田捕手
麦田捕手是谁的专辑	MUSIC_SEARCH	ALBUMNAME:麦田捕手
麦田捕手这张专辑是谁出的	MUSIC_SEARCH	ALBUMNAME:麦田捕手
麦田捕手里面有几首歌	MUSIC_SEARCH	ALBUMNAME:麦田捕手
黄勇的歌曲是不是很优美	MUSIC_SEARCH	ARTIST_OR_COMPOSER:黄勇
黄嘉千唱的如果我们在恋爱	MUSIC_SEARCH	ARTIST_OR_COMPOSER:黄嘉千	TITLE:如果我们在恋爱
黄思婷专辑的信息	MUSIC_SEARCH	ARTIST_OR_COMPOSER:黄思婷
黄梅戏上网查查	MUSIC_SEARCH	GENRE:黄梅戏
黄蓝白最新专辑是什么	MUSIC_SEARCH	ARTIST_OR_COMPOSER:黄蓝白
黄阅新专辑	MUSIC_SEARCH	ARTIST_OR_COMPOSER:黄阅
黄霑新专辑	MUSIC_SEARCH	ARTIST_OR_COMPOSER:黄霑
黄露仪最新专辑是什么	MUSIC_SEARCH	ARTIST_OR_COMPOSER:黄露仪
黎骏唱了控制不了吗	MUSIC_SEARCH	ARTIST_OR_COMPOSER:黎骏	TITLE:控制不了
黑夜尽头被谁翻唱过	MUSIC_SEARCH	TITLE:黑夜尽头
黛安娜罗丝歌组	MUSIC_SEARCH	ARTIST_OR_COMPOSER:黛安娜罗丝
