青藏高原是哪个专辑的	MUSIC_FIND_ALBUM	TITLE:青藏高原
七里香是哪个专辑的	MUSIC_FIND_ALBUM	TITLE:七里香
周杰伦的菊花台出自什么专辑	MUSIC_FIND_ALBUM	ARTIST_OR_COMPOSER:周杰伦	TITLE:菊花台
给我说一下陈奕迅的十年的专辑名	MUSIC_FIND_ALBUM	ARTIST_OR_COMPOSER:陈奕迅	TITLE:十年
给我说下梁静茹的呵护的专辑是什么啊	MUSIC_FIND_ALBUM	ARTIST_OR_COMPOSER:梁静茹	TITLE:呵护
说下黄绮珊的为你我受冷风吹的专辑名字是什么啊	MUSIC_FIND_ALBUM	ARTIST_OR_COMPOSER:黄绮珊	TITLE:为你我受冷风吹
我想知道邓紫棋的喜欢你的专辑名是什么	MUSIC_FIND_ALBUM	ARTIST_OR_COMPOSER:邓紫棋	TITLE:喜欢你
牛仔很忙的专辑名是什么	MUSIC_FIND_ALBUM	TITLE:牛仔很忙
给我说下黑色幽默的专辑名是什么	MUSIC_FIND_ALBUM	TITLE:黑色幽默
饿狼传说的专辑是什么啊	MUSIC_FIND_ALBUM	TITLE:饿狼传说
去大理的专辑名字	MUSIC_FIND_ALBUM	TITLE:去大理
董小姐的专辑名	MUSIC_FIND_ALBUM	TITLE:董小姐
一个人的旅行的专辑名是什么	MUSIC_FIND_ALBUM	TITLE:一个人的旅行
告白气球的专辑名是什么啊	MUSIC_FIND_ALBUM	TITLE:告白气球
找下算什么男人的专辑名是什么啊	MUSIC_FIND_ALBUM	TITLE:算什么男人
说下给我一首歌的时间的专辑名是什么啊	MUSIC_FIND_ALBUM	TITLE:给我一首歌的时间
搜下稻香的专辑名是什么	MUSIC_FIND_ALBUM	TITLE:稻香
我想搜下青花瓷的专辑名是什么	MUSIC_FIND_ALBUM	TITLE:青花瓷
我要搜下烟花易冷的专辑是什么	MUSIC_FIND_ALBUM	TITLE:烟花易冷
我要搜下最长的电影的专辑名字是什么	MUSIC_FIND_ALBUM	TITLE:最长的电影
我想要搜下发如雪的专辑是什么	MUSIC_FIND_ALBUM	TITLE:发如雪
我想要搜一下听妈妈的话的专辑是什么	MUSIC_FIND_ALBUM	TITLE:听妈妈的话
我想知道蒲公英的约定的专辑名字	MUSIC_FIND_ALBUM	TITLE:蒲公英的约定
我要知道菊花台的专辑名字	MUSIC_FIND_ALBUM	TITLE:菊花台
找一下张靓颖的画心的专辑	MUSIC_FIND_ALBUM	ARTIST_OR_COMPOSER:张靓颖	TITLE:画心
找下张靓颖的爱的供养的专辑	MUSIC_FIND_ALBUM	ARTIST_OR_COMPOSER:张靓颖	TITLE:爱的供养
找下张靓颖的离歌的专辑是什么	MUSIC_FIND_ALBUM	ARTIST_OR_COMPOSER:张靓颖	TITLE:离歌
搜一下许巍的蓝莲花的专辑名	MUSIC_FIND_ALBUM	ARTIST_OR_COMPOSER:许巍	TITLE:蓝莲花
搜下汪峰的春天里的专辑名字是什么啊	MUSIC_FIND_ALBUM	ARTIST_OR_COMPOSER:汪峰	TITLE:春天里
搜下凤凰传奇的最炫名族风的专辑名称是什么啊	MUSIC_FIND_ALBUM	ARTIST_OR_COMPOSER:凤凰传奇	TITLE:最炫名族风
搜下许巍的曾经的你的专辑名是什么	MUSIC_FIND_ALBUM	ARTIST_OR_COMPOSER:许巍	TITLE:曾经的你
搜下林俊杰的歌醉赤壁的专辑名是什么	MUSIC_FIND_ALBUM	ARTIST_OR_COMPOSER:林俊杰	TITLE:醉赤壁
给我搜下许巍的像风一样自由的专辑名是什么	MUSIC_FIND_ALBUM	ARTIST_OR_COMPOSER:许巍	TITLE:像风一样自由
给我搜下那英的歌曲一笑而过的专辑名是什么	MUSIC_FIND_ALBUM	ARTIST_OR_COMPOSER:那英	TITLE:一笑而过
我要陈奕迅的最佳损友的专辑名称	MUSIC_FIND_ALBUM	ARTIST_OR_COMPOSER:陈奕迅	TITLE:最佳损友
说一下孙燕姿的我怀念的的专辑名	MUSIC_FIND_ALBUM	ARTIST_OR_COMPOSER:孙燕姿	TITLE:我怀念的
说一下邓紫棋的北京北京的专辑名是什么	MUSIC_FIND_ALBUM	ARTIST_OR_COMPOSER:邓紫棋	TITLE:北京北京
说一下孙燕姿的歌我怀念的的专辑名是什么	MUSIC_FIND_ALBUM	ARTIST_OR_COMPOSER:孙燕姿	TITLE:我怀念的
说一下庄心妍的歌一万个舍不得的专辑名字	MUSIC_FIND_ALBUM	ARTIST_OR_COMPOSER:庄心妍	TITLE:一万个舍不得
说下tfboys的歌青春修炼册的专辑名字	MUSIC_FIND_ALBUM	ARTIST_OR_COMPOSER:tfboys	TITLE:青春修炼册
说下张惠妹的歌曲哭砂的专辑名字	MUSIC_FIND_ALBUM	ARTIST_OR_COMPOSER:张惠妹	TITLE:哭砂
容祖儿的专辑有哪些	MUSIC_FIND_ALBUM	ARTIST_OR_COMPOSER:容祖儿
找一下蔡依林的专辑有哪些	MUSIC_FIND_ALBUM	ARTIST_OR_COMPOSER:蔡依林
搜一下范玮琪的专辑有哪些	MUSIC_FIND_ALBUM	ARTIST_OR_COMPOSER:范玮琪
搜下张碧晨的专辑名有哪些	MUSIC_FIND_ALBUM	ARTIST_OR_COMPOSER:张碧晨
搜下徐歌阳的专辑名称有哪些啊	MUSIC_FIND_ALBUM	ARTIST_OR_COMPOSER:徐歌阳
我想搜下王菲的专辑名字有哪些啊	MUSIC_FIND_ALBUM	ARTIST_OR_COMPOSER:王菲
我想知道曲婉婷的专辑有哪些啊	MUSIC_FIND_ALBUM	ARTIST_OR_COMPOSER:曲婉婷
我想了解那英的专辑名有哪些啊	MUSIC_FIND_ALBUM	ARTIST_OR_COMPOSER:那英
张磊的歌曲专辑有哪些	MUSIC_FIND_ALBUM	ARTIST_OR_COMPOSER:张磊
宋冬野的歌曲专辑是哪些	MUSIC_FIND_ALBUM	ARTIST_OR_COMPOSER:宋冬野
给我搜一下许嵩的歌曲专辑是哪些	MUSIC_FIND_ALBUM	ARTIST_OR_COMPOSER:许嵩
给我搜下薛之谦的歌曲专辑是哪些	MUSIC_FIND_ALBUM	ARTIST_OR_COMPOSER:薛之谦
给我找下朴树的歌曲专辑是哪些	MUSIC_FIND_ALBUM	ARTIST_OR_COMPOSER:朴树
张宇的歌专辑有哪几个	MUSIC_FIND_ALBUM	ARTIST_OR_COMPOSER:张宇
孙子涵的歌曲专辑有哪几个	MUSIC_FIND_ALBUM	ARTIST_OR_COMPOSER:孙子涵
给我搜一下张杰的歌专辑有哪几个	MUSIC_FIND_ALBUM	ARTIST_OR_COMPOSER:张杰
搜一下李荣浩的歌专辑有哪几个	MUSIC_FIND_ALBUM	ARTIST_OR_COMPOSER:李荣浩
想知道林俊杰的歌专辑有哪几个	MUSIC_FIND_ALBUM	ARTIST_OR_COMPOSER:林俊杰
想了解杨宗纬的歌专辑有哪几个啊	MUSIC_FIND_ALBUM	ARTIST_OR_COMPOSER:杨宗纬
想搜一下庄心妍的歌专辑有哪几个啊	MUSIC_FIND_ALBUM	ARTIST_OR_COMPOSER:庄心妍
想搜下张学友的歌专辑名有哪几个	MUSIC_FIND_ALBUM	ARTIST_OR_COMPOSER:张学友
想搜下刘德华的歌专辑名字有哪几个	MUSIC_FIND_ALBUM	ARTIST_OR_COMPOSER:刘德华
想搜下孙楠的歌专辑名称有哪几个	MUSIC_FIND_ALBUM	ARTIST_OR_COMPOSER:孙楠
想要知道韩红的歌专辑有哪几个	MUSIC_FIND_ALBUM	ARTIST_OR_COMPOSER:韩红
想要知道韩磊的歌专辑有哪几个	MUSIC_FIND_ALBUM	ARTIST_OR_COMPOSER:韩磊
这首歌出自哪张专辑	MUSIC_FIND_ALBUM	ANAPHOR:这首歌
这首歌是哪张专辑的	MUSIC_FIND_ALBUM	ANAPHOR:这首歌
这首歌来自哪一张专辑	MUSIC_FIND_ALBUM	ANAPHOR:这首歌
这是哪个专辑里的	MUSIC_FIND_ALBUM
告诉我这首歌的专辑的信息	MUSIC_FIND_ALBUM	ANAPHOR:这首歌
这个歌曲来自于哪个乐队的哪张专辑	MUSIC_FIND_ALBUM	ANAPHOR:这个歌曲
这首歌在哪个唱片里	MUSIC_FIND_ALBUM	ANAPHOR:这首歌
这个歌曲来自于哪张唱片	MUSIC_FIND_ALBUM	ANAPHOR:这个歌曲
牛仔很忙是哪个专辑里的	MUSIC_FIND_ALBUM	TITLE:牛仔很忙
我怀念的是哪个专辑里的啊	MUSIC_FIND_ALBUM	TITLE:我怀念的
以父之名专辑	MUSIC_FIND_ALBUM	TITLE:以父之名
我怀念的专辑	MUSIC_FIND_ALBUM	TITLE:我怀念的
去大理专辑名	MUSIC_FIND_ALBUM	TITLE:去大理
一万个舍不得专辑名	MUSIC_FIND_ALBUM	TITLE:一万个舍不得
牛仔很忙专辑	MUSIC_FIND_ALBUM	TITLE:牛仔很忙
黑色幽默专辑	MUSIC_FIND_ALBUM	TITLE:黑色幽默
